a,ga,na	अँ,ग,ना
a,ga,na	अं,ग,ना
aa,ga,n	आँ,ग,न
kaa,rya,ka,rta	का,र्य,क,र्ता
traa,va,n,ko,r	ट्रा,व,ण,को,र
la,ha,ron	ल,ह,रों
du,rgh,ta,na	दु,र्घ,ट,ना
pa,ha,chaa,n	प,ह,चा,न
pa,ha,na,yi	प,ह,ना,ई
7,ju,n	7, ,जू,न
r	र,ख्ने
kho,la,ne	खो,ल,ने
kho,la,na	खो,ल,ना
raa,ja,swa	रा,ज,स्व
baa,su,ri,ya	बाँ,सु,रि,या
bi,chha,de,gi	बि,छ,ड़े,गी
jhu,kaa,ye	झु,का,ए
jhu,kaa,o	झु,का,ओ
jhu,kaa,yi	झु,का,ई
kha,ja,raa,na	ख,ज,रा,ना
ka,ma,la,na,th	क,म,ल,ना,थ
aa,za,maa,o	आ,ज़,मा,ओ
aa,za,maa,yi	आ,ज़,मा,ई
ndi,ye,n,ye	डी,ए,न,ए
sa,da,bu,ddh	स,द,बु,द्ध
a,ta,ka,la	अ,ट,क,ल
ri,jhaa,n,gi	रि,झा,ऊँ,गी
ndi,ye,n,ye	डी,ए,न,ए
ha,r,jaa,yi	ह,र,जा,ई
aa,pa,hu	आ,प,हु
jo,n	जो,ताँ
di,ya	दी,या
jhaa,bu,aa	झा,बु,आ
go,li,n	गो,लि,याँ
chaa,hoo	चा,हूँ
pa,r,ba,ta	प,र,ब,त
pa,r,bhaa,ta	प,र,भा,त
su,n,saa,n	सु,न,सा,न
su,saa,n	सुं,सा,न
di,ji,ye	दी,जि,ए
be,pa,r,vaa,ha	बे,प,र,वा,ह
ma,ha,boo,baa	म,ह,बू,बा
vaa,le	वा,ले
pi,ja,raa	पिं,ज,रा
vaa,le	वा,ले
pi,ja,re	पिं,ज,रे
mo,ha,raa	मो,ह,रा
pa,raa,ye	प,रा,ए
pa,raa,yi	प,रा,ई
di,khaa,n,gaa	दि,खा,ऊँ,गा
a,llaa,ha	अ,ल्ला,ह
a,llaa	अ,ल्ला
ha,tyaa	ह,त्या
paa,la,ki	पा,ल,की
phu,la,vaa,ri	फु,ल,वा,री
ku,shi,n	ख़ु,शि,याँ
da,ri,ya	द,रि,या
ve,ta,n,maa,n	वे,त,न,मा,न
sa,ha,ti	स,ह,ती
va,faa,yon	व,फ़ा,ओं
pi,chha,de	पि,छ,ड़े
a,ha,ma,da	अ,ह,म,द
ta,ha,si,la,daa,r	त,ह,सी,ल,दा,र
i,da,li	इ,ड,ली
u,thaa,i,n	उ,ठा,इ,न
pa,ha,na,o	प,ह,ना,ओ
pe,ha,na,o	पे,ह,ना,ओ
ma,ja,boo,ri	म,ज,बू,री
jhaa,bu,aa	झा,बु,आ
aa,yi,ne	आ,ई,ने
kyaa	क्या
mu,khya,ma,tri	मु,ख्य,मं,त्री
cha,ma,ka,te	च,म,क,ते
cha,ma,ka,taa	च,म,क,ता
cha,ma,ka,ti	च,म,क,ती
ma,ha,suu,sa	म,ह,सू,स
laa,i,laa,ja	ला,इ,ला,ज
ka,haa	क,हाँ
ka,vi,taa,ye	क,वि,ता,एँ
do,ston	दो,स्तों
ma,sa,rr,ta	म,स,र्र,त
chuu,di,n	चू,ड़ि,याँ
kaa,rya,shai,li	का,र्य,शै,ली
da,r,baa,ron	द,र,बा,रों
be,sa,haa,re	बे,स,हा,रे
ji,sa,me	जि,स,में
khaa,n,daa,n	खा,न,दा,न
pa,kaa,ye,gi	प,का,ए,गी
che,ta,na	चे,त,ना
sa,ha,raa,yon	स,ह,रा,ओं
ma,cha,luu	म,च,लूँ
vi,she,sha	वि,शे,ष
u,tha,ka,r	उ,ठ,क,र
li,pa,taa	लि,प,टा
ju,baa,ya,daa	जु,बा,य,दा
me,mo,ri,ya,la	मे,मो,रि,य,ल
u	उ,न्वाँ
ja,ba,se	ज,ब,से
bha,ru	भ,रूँ
hai	है,।
ha,si	हँ,सी
haa,ya	हा,य
hai	:,हैं,:
haa	हा
haa	हाँ
ha	हँ
ho	हो
ma,da,ho,sha	म,द,हो,श
ma,da,ho,sha	म,द,हो,ष
hai	है
haa	हा
aa,ja,maa,i,sha	आ,ज,मा,इ,श
kaa,r,n	का,र,वाँ
u,lle,kha,ni,ya	उ,ल्ले,ख,नी,य
ka,rma	क,र्म
sa,r,sa,raa,ye	स,र,स,रा,एं
ai,ta,baa,r	ऐ,त,बा,र
sa,vaa,ru	स,वा,रूँ
chha,ti,n	छ,ति,याँ
ye,ma,bi,ye	ए,म,बी,ए
sa,r,kaa,r	स,र,का,र
bu,laa,ye	बु,ला,एं
vaa,de	वा,दे
yi,da,u,la,phi,tta,r	ई,द,उ,ल,फि,त्त,र
di,la,ru,baa	दि,ल,रु,बाँ
sa,ma,jhaa,yuu	स,म,झा,ऊं
a,bhi,ya,n	अ,भि,या,न
ma,ta,vaa,li	म,त,वा,ली
ma,ta,vaa,le	म,त,वा,ले
ma,ta,vaa,laa	म,त,वा,ला
raa,ja,swa	रा,ज,स्व
gu,la,si,n	गु,ल,सि,ताँ
gaa,ye,gaa	गा,ए,गा
laa,ye,gi	ला,ए,गी
te,ri,n	ते,री,याँ
te,ri,n	टे,रि,याँ
bu,laa,ye	बु,ला,ए
cha,ya,n	च,य,न
raa,sa,taa	रा,स,ता
khe,ti	खे,ती
ma,ha,boo,ba	म,ह,बू,ब
a,ha,ma,daa,baa,da	अ,ह,म,दा,बा,द
sa,ja,te	स,ज,ते
la,bon	ल,बों
sa,ja,n,vaa	स,ज,न,वा
a,n,jaa,n	अ,न,जा,न
a,jaa,n	अं,जा,न
sa,jaa,n	स,जा,ऊँ
su,ba,he	सु,ब,हें
li,kha,na	लि,ख,ना
li,kha,ne	लि,ख,ने
a,bdu,llaa	अ,ब्दु,ल्ला
chu,raa,o,nge	चु,रा,ओ,गे
aa,sa,maa,non	आ,स,मा,नों
kra,maa,ka	क्र,मां,क
5,5	5,4,5
saa,thi,ya	सा,थि,या
jha,ga,da,ka,r	झ,ग,ड़,क,र
ti,ta,li,yaan	ति,त,लि,यां
sha,r,maa,ti	श,र,मा,ती
sha,r,maa,taa	श,र,मा,ता
pa,lko,n	प,ल्को,न
pa,lkon	प,ल्कों
chi,ma,na	चि,म,ना
bu,n,taa	बु,न,ता
ga,ga,ri	ग,ग,री
u,sa,ne	उ,स,ने
pa,ri,ksha,yon	प,री,क्षा,ओं
li,kha,ne	लि,ख,ने
pa,ha,ne,gi	प,ह,ने,गी
ma,n,vaa	म,न,वा
khu,sha,boo	खु,श,बू
ji,ye	जि,ए
ji,ya	जि,या
ji,yo	जि,यो
u,gaa,ye	उ,गा,एं
bhaa,bhi,n	भा,भि,याँ
u,pa,la,bdha	उ,प,ल,ब्ध
gu,za,r,na	गु,ज़,र,ना
laa,n,gaa	ला,ऊँ,गा
la,da,kon	ल,ड़,कों
ba,n	ब,याँ
n,za,raa,na	न,ज़,रा,ना
cha,la,daa	च,ल,दा
chi,kaa	चि,काँ
sa,r,ma,sti,n	स,र,म,स्ति,याँ
r,ja,ni	र,ज,नी
daa,ku,yon	डा,कु,ओं
kho,luu	खो,लूँ
ha,me	ह,में
pa,r,chhaa,yi	प,र,छा,ई
ye,ka,baa,r	ए,क,बा,र
a,fa,saa,ne	अ,फ़,सा,ने
a,fa,saa,na	अ,फ़,सा,ना
a,fa,saa,n	अ,फ़,सा,न
ho,ye,laa	हो,ए,ला
ma,sji,da	म,स्जि,द
ja,ga,ha	ज,ग,ह
bu,la,bu,lon	बु,ल,बु,लों
ja,gaa,yuu	ज,गा,ऊं
jaa	जा
aa,shi,ya,na	आ,शि,या,ना
di,la,ja,lon	दि,ल,ज,लों
bi,chha,da,ne	बि,छ,ड़,ने
bi,chha,da,na	बि,छ,ड़,ना
i,ka,raa,r	इ,क,रा,र
jyo,ti,ma,da,la	ज्यो,ति, ,मं,ड,ल
sha,r,maa,ye,gi	श,र,मा,ए,गी
sha,r,maa,ye,gi	श,र,मा,ये,गी
gau,r,ta,la,ba	गौ,र,त,ल,ब
zi,nda,baa	ज़ि,न्दा,बा
si,vaa,ya	सि,वा,य
ye,sa	ए,स
ha,vaa,yi	ह,वा,ई
u,ja,li	उ,ज,ली
u,ja,le	उ,ज,ले
u,ja,laa	उ,ज,ला
ba,da,gu,maa	ब,द,गु,मा
fa,r,maa,i,sha	फ,र,मा,इ,श
ki,n,ne	कि,न,ने
do,vaa,si,yon	दो,वा,सि,यों
ba,ha,laa,ye	ब,ह,ला,ए
ga,r,je	ग,र,जे
ga,r,jaa	ग,र,जा
dha,ma,ki,yon	ध,म,कि,यों
sa,ma,jhaa,i,ye	स,म,झा,इ,ये
praa,kri,ti,ka	प्रा,कृ,ति,क
a,ma	अ,म,ब्वा
a,su,a,n	अँ,सु,अ,न
a,su,a,n	अं,सु,अ,न
u,n,ki	उ,न,की
gu,jaa,ru	गु,जा,रूँ
pa,la,ka,n	प,ल,क,न
sa,ma,jhaa,n	स,म,झा,ऊँ
pu,kaa,ru	पु,का,रूँ
pa,hu,cha,te	प,हुँ,च,ते
ye,ha,saa,non	ए,ह,सा,नों
chhu,pa,te	छु,प,ते
chhu,pa,ti	छु,प,ती
nyu,n,ta,ma	न्यू,न,त,म
ma,ha,ka,taa	म,ह,क,ता
tu,jha,ko	तु,झ,को
jaa,n	जा,न
ja,haa	ज,हा
ja,haa	ज,हाँ
ni,ma,tra,n	नि,मं,त्र,ण
ho,pa,nki,sa	हॉ,प,किं,स
chhu,paa,ye	छु,पा,ए
chhu,paa,yi	छु,पा,ई
chhu,paa,o	छु,पा,ओ
sa,vi,chaa,r	स,द्,‍, ,वि,चा,र
bi,je,pi	बी,जे,पी
bhaa,ja,paa	भा,ज,पा
ba,ba,li	ब,ब,ली
faa,sa,laa	फ़ा,स,ला
ya	या
sa,n,ma	स,न,म
ru,koo	रु,कूँ
na,cha,ne	ना,च,ने
su,dhi,n	सु,धि,याँ
jaa,ye,gaa	जा,ए,गा
jaa,ye,gaa	जा,ये,गा
chu,kaa,yi	चु,का,ई
u,bha,ru	उ,भ,रूँ
ta,ka,raa	ट,क,रा
ji,sa,ko	जि,स,को
du,la,he,raa,je	दू,ल,हे,रा,जे
ja,ga,ti	ज,ग,ती
jaa,ga,ti	जा,ग,ती
jaa,ga,taa	जा,ग,ता
ye,ka,ju,ta	ए,क,जु,ट
la,ha,raa,te	ल,ह,रा,ते
la,ha,raa,taa	ल,ह,रा,ता
pu,aa,de	पु,आ,दे
la,ha,raa,ti	ल,ह,रा,ती
u,ma,da,taa	उ,म,ड़,ता
do,o,r	दो,ओ,र
gu,ma,su,ma	गु,म,सु,म
du	दूँ
ni,ka,luu	नि,क,लूं
saa,ma,ne	सा,म,ने
a,mbe,da,ka,r	अ,म्बे,द,क,र
gha,ba,daa,ka,r	घ,ब,ड़ा,क,र
ba,ga,le	बं,ग,ले
ba,ga,laa	बं,ग,ला
ba,ga,laa	बँ,ग,ला
khaa,o,nge	खा,ओ,गे
i,saa,yi	इ,सा,ई
n,ga,maa	न,ग़,मा
de,kha,na	दे,ख,ना
ta,r,sa,te	त,र,स,ते
raa,khuu	रा,खूँ
hai,da,raa,baa,da	है,द,रा,बा,द
bi,chhaa,ye	बि,छा,ए
a,su,a,n	अ,सु,अ,न
ye,va	ए,वं
bho,o,la	भो,ओ,ल
na,cha	ना,च
pa,ha,chaa,nuun	प,ह,चा,नूं
bha,da,kaa,ye	भ,ड़,का,एं
tu,ma,me	तु,म,में
ni,ka,laa	नि,क,ला
su,la,jhaa,ye	सु,ल,झा,ए
cha,r,non	च,र,णों
ma,n,bhaa,va,n	म,न,भा,व,न
ba,da,la,ka,r	ब,द,ल,क,र
su,nda,r,taa	सु,न्द,र,ता
su,da,r,taa	सुं,द,र,ता
da,vaa,yon	द,वा,ओं
fa,r,maa,i,ye,gaa	फ़,र,मा,इ,ये,गा
bi,taa,ye	बि,ता,एँ
mu,sku,raa,i,ye	मु,स्कु,रा,इ,ये
thu,ka,raa,na	ठु,क,रा,ना
ma,ta,vaa,ri	म,त,वा,री
ma,ta,vaa,raa	म,त,वा,रा
khu,sha,boo	खु,श,बू
ma,ta,vaa,re	म,त,वा,रे
su,n,ne	सु,न,ने
su,n,na	सु,न,ना
ma,sa,ru,fa	म,स,रू,फ़
ma,ha,ttva,poo,rna	म,ह,त्त्व,पू,र्ण
ha,taa,o	ह,टा,ओ
ba,ha,laa,n	ब,ह,ला,ऊँ
a,ma,r,vaa	अ,म,र,वा
aa,ya,ta,n,taa	आ,य,त,न,ता
a,va,gu,n	अ,व,गु,न
la,daa,yi	ल,ड़ा,ई
pa,saa,re	प,सा,रे
pa,laa,ni,ma,kka,ma	प,ला,नि,म,क्क,म
di,kha,laa,ya	दि,ख,ला,य
di,kha,laa,ye	दि,ख,ला,ये
ri,ya,la	रि,य,ल
mu,jha,saa	मु,झ,सा
jhaa,bu,aa	झा,बु,आ
tai,ya,ri,yon	तै,या,रि,यों
va,ga,li	व,ग,ली
me,re	मे,रे
ba,laa,yon	ब,ला,ओं
u,pa,ka,r,n	उ,प,क,र,ण
di,la,ba,r	दि,ल,ब,र
sha,r,maa,ye	श,र,मा,ये
sha,r,maa,ya	श,र,मा,या
sha,r,maa,yi	श,र,मा,यी
chuu,n,ri,ya	चू,न,रि,या
chu,n,ri,n	चु,न,रि,याँ
kyaa	क्या
ta,ka,raa,o,nge	ट,क,रा,ओ,गे
ba,r,baa,da	ब,र,बा,द
do,ha,raa,ye	दो,ह,रा,ए
ba,r,ba,sa	ब,र,ब,स
ba,ha,ka,ne	ब,ह,क,ने
a,va,sa,r	अ,व,स,र
shaa,ha	शा,ह
aa,r,ti	आ,र,ती
r,chaa,ye	र,चा,ए
r,chaa,yi	र,चा,ई
r,chaa,o	र,चा,ओ
sa,r,ka,taa	स,र,क,ता
chhaa,yi	छा,ई
chaa,ya	चा,य
dha,n,ba,la	ध,न,ब,ल
ha,ri,ya,ye	ह,रि,या,ए
khi,da,ki	खि,ड़,की
ma,n,cha,laa	म,न,च,ला
ma,n,cha,le	म,न,च,ले
ma,n,cha,li	म,न,च,ली
sa,pa,non	स,प,नों
ka,haa,n	क,हा,ऊँ
bhu,li,ye	भू,लि,ए
ga,la,ti,yon	ग,ल,ति,यों
bi,sa,raa,na	बि,स,रा,ना
ta,ma,nna,o	त,म,न्ना,ओ
ta,ma,nna,yon	त,म,न्ना,ओं
jaa,ye,nge	जा,एं,गे
jaa,ye,nge	जा,एँ,गे
i,shaa,re	इ,शा,रे
jaa,ye,gi	जा,एँ,गी
jaa,ye,gi	जा,एं,गी
fi,zaa,yon	फ़ि,ज़ा,ओं
sa,r,sa,raa,ti	स,र,स,रा,ती
yo,ja,na,yon	यो,ज,ना,ओं
ta,da,paa,n	त,ड़,पा,ऊँ
cha,dha,ti	च,ढ़,ती
te,la,ha,n	ते,ल,ह,न
cha,dha,taa	च,ढ़,ता
pa,dhaa,o,gi	प,ढ़ा,ओ,गी
jaa,yuu,gi	जा,ऊं,गी
ji,n,se	जि,न,से
she,raa	शे,राँ
bi,ga,di	बि,ग,ड़ी
gu,za,re,gi	गु,ज़,रे,गी
pa,le	प,ले
bi,chhu,aa	बि,च्छु,आ
ba,da,na,ma	ब,द,ना,म
pa,r,daa	प,र,दा
pa,r,de	प,र,दे
r,so,yi	र,सो,ई
baa,va,ri	बाँ,व,री
la,ha,raa,yi	ल,ह,रा,ई
duu,ba,ne	डू,ब,ने
du,ba,ne	दू,ब,ने
i,sa,me	इ,स,में
jaa,nge	जा,गे
hi,va,daa	हि,व,ड़ा
chu,na,va	चु,ना,व
mi,ta,vaa	मि,त,वा
dha,da,kaa,ti	ध,ड़,का,ती
vi,shva,na,th,n	वि,श्व,ना,थ,न
bi,daa,yi	बि,दा,ई
bi,daa,i	बि,दा,इ
baa,r,le	बा,र,ले
ka,ma,raa	क,म,रा
i,raa,ka	इ,रा,क
za,ri,ye	ज़,रि,ए
saa,maa	सा,माँ
ga,yi	:,ग,ई,:
ho	हो
ra,ga,na	रं,ग,ना
ra,ga,ne	रं,ग,ने
tu,ja,gau,ri	तु,ज,गौ,री
a,r,maa,non	अ,र,मा,नों
ka,rma,chaa,ri	क,र्म,चा,री
nge,hu	गे,हुँ
vi,dhaa,n,sa,bhaa	वि,धा,न,स,भा
thi,ka,thaa,ka	ठी,क,ठा,क
pa,ndra,ha	पं,द्र,ह
jaa	जाँ
jaa,o	जा,ओ
jaa,yi	जा,ई
ja,ya	ज,य
jaa	जा
jaa,ye	जा,ए
jaa	जा
jaa,n	जा,न
si,kha,ne	सी,ख,ने
du,ba,ki,n	डु,ब,कि,याँ
gha,di,n	घ,ड़ि,याँ
sa,vi,chaa,r	स,द्,‍, ,वि,चा,र
pa,laa,ni,ma,kka,ma	प,ला,नि,म,क्क,म
sa,chaa,la,ya	सं,चा,ल,य
re,sha,mi	रे,श,मी
kha,n,kaa	ख,न,का
ma,r,ti	म,र,ती
ma,r,taa	म,र,ता
ma,r,te	म,र,ते
gu,da,gu,daa,ke	गु,द,गु,दा,के
pa,ri,shaa	प,री,शाँ
faa,sa,le	फ़ा,स,ले
ba,n,na	ब,न,ना
chhe,da,taa	छे,ड़,ता
a,ga,le	अ,ग,ले
ja,ga,ma,gaa,o	ज,ग,म,गा,ओ
bai,n	बै,याँ
mu,sa,ku,raa,ye	मु,स,कु,रा,यें
a,ha,ma,daa,baa,da	अ,ह,म,दा,बा,द
ve	वे
ja,ga,ma,gaa,ne	ज,ग,म,गा,ने
pa,ya,ri	प,या,री
pi,ya,ri	पि,या,रि
pi,ya,ri	पि,या,री
kyu	क्य़ूँ
kyo	क्यूँ
	क्युँ
ma,n,mo,r	म,न,मो,र
ma,n,te	म,न,ते
maa,n,taa	मा,न,ता
maa,n,ti	मा,न,ती
mi,laa,o,nge	मि,ला,ओ,गे
u,ja,de	उ,ज,ड़े
ma,ha,ja,bi,non	म,ह,ज,बी,नों
u,ja,di	उ,ज,ड़ी
pra,saa,r,n	प्र,सा,र,ण
mu,skaa,ye	मु,स्का,ए
mu,skaa,ye	मु,स्का,ये
saa,ga,to	सां,ग,तो
ru,sa,vaa,i,yon	रु,स,वा,इ,यों
ba,r,se,gaa	ब,र,से,गा
ba,r,se,gi	ब,र,से,गी
bai,the	बै,ठे
aa,jaa,ye,gaa	आ,जा,ये,गा
chhu,paa,n,gi	छु,पा,ऊँ,गी
ka,r,ma,ko	क,र,म,को
ma,r,na	म,र,ना
haa,da,shaa,ha	हा,द,शा,ह
bhu,luu	भू,लूँ
ja,laa,ya,le	ज,ला,य,ले
ga,r,be	ग,र,बे
sa,ma,jhaa,ye	स,म,झा,यें
maa,pa,ne	मा,प,ने
chi,di,n	चि,ड़ि,याँ
ka,r,va,te	क,र,व,टें
ja,laa,o,nge	ज,ला,ओ,गे
ba,cha,ka,r	ब,च,क,र
baa,to,i,n	बा,टो,इ,न
nsoo	सूँ
ta,ka,raa,ke	ट,क,रा,के
jhu,laa,ye	झु,ला,ए
ba,saa,o	ब,सा,ओ
ba,saa,yi	ब,सा,ई
ba,saa,yi	ब,सा,यी
ba,saa,ye	ब,सा,ए
me,ha,r,baa	मे,ह,र,बां
ba,ha,kaa,ye	ब,ह,का,ए
ksha,ma,taa	क्ष,म,ता
ba,ha,kaa,o	ब,ह,का,ओ
ba,ha,kaa,yi	ब,ह,का,ई
ro,ka,na	रो,क,ना
ta,da,poo	त,ड़,पूँ
gu,r,ba,ta	गु,र,ब,त
zi,da,gaa,ni	ज़िं,द,गा,नी
ho,n	हो,याँ
da,r,pa,n	द,र,प,न
ji,da,gaa,ni	जिं,द,गा,नी
ti,ka,li	टि,क,ली
1,3	1,9,9,3
1,do	1,9,9,2
1,6	1,9,9,6
1	1,9,9,9
bha,va,n,swaa,mi,yon	भ,व,न, ,स्वा,मि,यों
su,r,ma,yi	सु,र,म,ई
a,bu	अ,बु
ba,ta,laa,ye,gaa	ब,त,ला,ए,गा
ndra,vi,n,ma	द्र,वि,ण,म
cha,ta,pa,ti	च,ट,प,टी
poo,chho,o	पू,छो,ओ
ya,raa	या,रा
aa,i,yo	आ,इ,यो
aa,i,ya	आ,इ,या
aa,i,ye	आ,इ,ये
aa,yi,ye	आ,ई,ये
ma,na	म,ना,वूँ
baa,li,n	बा,लि,याँ
gha,r,baa,r	घ,र,बा,र
ma,ha,kaa,ye	म,ह,का,ए
aa,i	आ,इ
daa,luu	डा,लूँ
si,ma,ta,ke	सि,म,ट,के
i,mte,haa	इ,म्ते,हाँ
baa,va,ri	बां,व,री
a,khi,n	अँ,खि,याँ
u,pa,na,ma	उ,प,ना,म
a,dha,kaa,r	अं,ध,का,र
a,dha,kaa,r	अँ,ध,का,र
ba,la,khaa,yi	ब,ल,खा,ई
ba,dha,te	ब,ढ़,ते
ba,dha,te	ब,ढ़,ते
ka,sa,ma,saa,ti	क,स,म,सा,ती
ta,r,ka,sa	त,र,क,स
ka,cha,ha,ri	क,च,ह,री
da,rd,ma,ndon	द,र्द,म,न्दों
mi,khaa,i,la	मि,खा,इ,ल
hu,yon	हु,ओं
ha,vaa,ye	ह,वा,एँ
daa,li,n	डा,लि,याँ
li,pa,ta,ke	लि,प,ट,के
be,maa,ri,n	बे,मा,रि,याँ
ka,da,r,daa,n	क,द,र,दा,न
di,la,cha,spa	दि,ल,च,स्प
baa,ta,chi,ta	बा,त,ची,त
r,haa	र,हा
gaa,ye	गा,एं
ma,ja,boo,ri,n	म,ज,बू,रि,याँ
bi,chhu,aa	बि,छु,आ
thu,ka,raa,ye	ठु,क,रा,यें
pa,r,vaa,na	प,र,वा,ना
ba,taa,li,ya,n	ब,टा,लि,य,न
bi,taa,yi	बि,ता,ई
aa,yi,na	आ,ई,ना
aa,i,na	आ,इ,ना
u,tha,ne	उ,ठ,ने
ka,ha,ke	क,ह,के
jhu,kaa,o,gi	झु,का,ओ,गी
ba,r,saa,ta	ब,र,सा,त
u,sa,me	उ,स,में
ba,r,saa	ब,र,सा
gha,taa,yon	घ,टा,ओं
jaa	जा
su,na,ye	सु,ना,एँ
su,na,ye	सु,ना,येँ
sa,saa,r	सं,सा,र,।
ma,da,ho,shi,yaan	म,द,हो,शि,यां
aa,n	आ,ऊँ
tu,jha,se	तु,झ,से
ne,taa,yon	ने,ता,ओं
cha,ma,kaa,yi	च,म,का,ई
pa,n,ba,kaa	प,न,ब,का
chaa,hi,ye	चा,हि,ए
chaa,hi,ye	चा,हि,ये
ma,ha,gaa,yi	म,हं,गा,ई
ha,sa,ka,r	हँ,स,क,र
la,ha,raa,ye	ल,ह,रा,एं
se,ha,raa	से,ह,रा
be,qa,da,re	बे,क़,द,रे
sa,chaa,la,n	सं,चा,ल,न
i,tha,laa,ye	इ,ठ,ला,ये
cha,laa,o,nge	च,ला,ओ,गे
u,stu,ka,taa	उ,स्तु,क,ता
chaa,ha,ti	चा,ह,ती
chaa,ha,te	चा,ह,ते
ki,ya	कि,या
chaa,ha,taa	चा,ह,ता
ni,bhaa,yi	नि,भा,ई
ni,bhaa,ye	नि,भा,ए
ro,o,nge	रो,ओ,गे
u,ga,li	उँ,ग,ली
u,ga,li	उं,ग,ली
be,chai,ni,n	बे,चै,नि,याँ
mi,luu	मि,लूँ
jo,dha,pu,r	जो,ध,पु,र
la,ma,haa,ta	ल,म,हा,त
pyaa,ri,n	प्या,रि,याँ
mi,taa,ye	मि,टा,ए
su,la,ga,ti	सु,ल,ग,ती
mi,taa,o	मि,टा,ओ
mi,taa,yi	मि,टा,ई
mi,taa,yi	मि,टा,यी
si,ma,ta,ne	सि,म,ट,ने
phu,la,kaa	फू,ल,का
r,ha,taa	र,ह,ता
r,ha,ti	र,ह,ती
ma,ha,ka,ti	म,ह,क,ती
ma,ha,ka,taa	म,ह,क,ता
ma,ha,ka,te	म,ह,क,ते
1,do,vi	1,2,वीं
dha,n,vaa,n	ध,न,वा,न
pa,ha,laa	प,ह,ला
ni,ka,le,gi	नि,क,ले,गी
chi,ka,ne	चि,क,ने
chi,ka,na	चि,क,ना
chi,ka,ni	चि,क,नी
ta,da,paa,ye,gi	त,ड़,पा,ए,गी
traa,va,n,ko,r	ट्रा,व,ण,को,र
cho,ti,n	चो,टि,याँ
ka,sa,mon	क,स,मों
chaa,ha,ti	चा,ह,ती
chaa,ha,te	चा,ह,ते
chaa,ha,taa	चा,ह,ता
ka,li,n	क,लि,योँ
ba,r,khaa	ब,र,खा
a,va,shya,ka,taa	अ,व,श्य,क,ता
su,na,ye,gi	सु,ना,ये,गी
cha	च,म्की
ga,le	ग,ले
ha,nsoo	ह,सूँ
jaa,n,va,r	जा,न,व,र
khya,laa,ta	ख्या,ला,त
sa,ma,ka,ksha	स,म,क,क्ष
pa,dha,taa	प,ढ़,ता
kha,n,kaa,ye,nge	ख,न,का,एं,गे
	ड्रॉ
	ड्रॉ
ye	ये
ya	या
ba,jaa,raa,pa,n	बं,जा,रा,प,न
haa,th,ka,ga,n	हा,थ,कं,ग,न
bhu,laa,o,nge	भु,ला,ओ,गे
di,khaa,yuu,gaa	दि,खा,ऊं,गा
ga,ma,gu,saa,r	ग़,म,गु,सा,र
a,n,mo,la	अ,न,मो,ल
bhi,ja,vaa	भि,ज,वा
luu	लूँ
taa,la,me,la	ता,ल, ,मे,ल
ka,rma	क,र्म
sa,ma,ndhi,ji	स,म,धी,जी
ha,ma,me	ह,म,में
pa,chha,taa,yi	प,छ,ता,ई
du	दूँ
o,r,ve,la	ऑ,र,वे,ल
su,la,jhaa,na	सु,ल,झा,ना
jaa,n,gi	जा,ऊँ,गी
jaa,yuu,gi	जा,ऊं,गी
ju,ye,ki	जु,ए,की
ga,li,n	ग,लि,याँ
shri,ma,ti	श्री,म,ती
ba,ta,laa,o	ब,त,ला,ओ
paa,yuu	पा,ऊं
paa,u,sa	पा,उ,स
i,ja,n	इं,ज,न
tu,jha,ko	तु,झ,को
saa,th,yi	सा,थ,ई
r,hma,ta	र,ह्म,त
ma,ma,taa	म,म,ता
khaa,o,nge	खा,ओ,गे
be,va,faa,yi	बे,व,फ़ा,ई
fa,r,maa,o,gi	फ़,र,मा,ओ,गी
jaa,te	जा,ते
jaa,ti	जा,ती
pa,chha,taa,ye	प,छ,ता,ए
kha,ba,r,daa,r	ख,ब,र,दा,र
jaa,na	जा,ना
ta,da,paa,na	त,ड़,पा,ना
ta,da,paa,ne	त,ड़,पा,ने
cha,ndra,pra,bhaa	चं,द्र,प्र,भा
swa,sa,haa,ya,taa	स्व,स,हा,य,ता
baa,i,sa	बा,इ,स
a,ha,ma,daa,baa,da	अ,ह,म,दा,बा,द
pu,kaa,ru	पु,का,रूँ
ta,da,paa,na	त,ड़,पा,ना
ba,la,khaa,ye	ब,ल,खा,यें
to	तो
phi,sa,la,n	फि,स,ल,न
da,r,baa,r	द,र,बा,र
dhaa,ri,n	धा,रि,याँ
la,cha,ka,ti	ल,च,क,ती
si,n	सि,ताँ
ba,ha,ka,taa	ब,ह,क,ता
sho,khi,n	शो,खि,याँ
ta,n,haa	त,न,हा
khu,daa,yi	खु,दा,ई
ku,daa,yi	ख़ु,दा,ई
aa,vaa,r,gi	आ,वा,र,गी
ja,taa,ye	ज,ता,ए
aa,ja,maa,na	आ,ज,मा,ना
gha,ba,raa,taa	घ,ब,रा,ता
tau,la,ti	तौ,ल,ती
aa,za,ma	आ,ज़,म
di,khaa,ye,gaa	दि,खा,ए,गा
sa,mbha,la,ka,r	स,म्भ,ल,क,र
de,va,raa,ni	दे,व,रा,नी
u,nna,ti	उ,न्न,ति
chu,raa,yuu,gaa	चु,रा,ऊं,गा
a,r,maa,non	अ,र,मा,नों
raa,jaa,yon	रा,जा,ओं
duu,ba,ti	डू,ब,ती
ba,da,maa,sha	ब,द,मा,श
sa,he,li,n	स,हे,लि,याँ
a,ta,ri,ksha	अं,त,रि,क्ष
be,khya,la	बे,ख्या,ल
to,da,na	तो,ड़,ना
ja,n	ज,वाँ
jaa,n	जा,न
ka,r,ni	क,र,नी
ka,r,ne	क,र,ने
ka,r,na	क,र,ना
bi,sa,raa,n	बि,स,रा,ऊँ
ta,nhaa,yi,yon	त,न्हा,ई,यों
pa,doo	प,ड़ूँ
maa,n,si,ka,taa,ye	मा,न,सि,क,ता,एं
aa,ja,ki	आ,ज,की
ne,ha,ru	ने,ह,रु
aa,ja,ke	आ,ज,के
si,le,sta,r	सि,ले,स्ट,र
thi,ka,thaa,ka	ठी,क,ठा,क
sa,ma,jhaa,i,ye	स,म,झा,इ,ये
i,za,haa,r	इ,ज़,हा,र
ma,rma	म,र्म
tu,la,si	तु,ल,सी
poo,chhuu	पू,छूँ
ma,da,laa,ye	मं,ड,ला,ये
ye,ha,saa,sa	ए,ह,सा,स
di,la,ba,r	दि,ल,ब,र
dha,da,ka,na	ध,ड़,क,ना
ja,laa,n	ज,ला,ऊँ
r,ha,gu,ja,r	र,ह,गु,ज,र
r,ha,te	र,ह,ते
r,ha,ti	र,ह,ती
a,ga,daa,yi	अँ,ग,ड़ा,ई
a,ng,daa,yi	अ,न्ग,डा,ई
a,ga,daa,yi	अं,ग,ड़ा,ई
i,ta,raa,o	इ,त,रा,ओ
paa,n	पा,ऊँ
sa,ja,daa	स,ज,दा
sa,ma,jhaa,n	स,म,झा,ऊँ
sa,ja,de	स,ज,दे
mu,kha,de	मु,ख,ड़े
mu,kha,daa	मु,ख,ड़ा
si,taa,ro	सि,ता,रो
aa,ye,gi	आ,ए,गी
pa,ha,chaa,n,ne	प,ह,चा,न,ने
bu,mba,ro	बु,म्ब,रो
ka,mi,n	क,मि,याँ
phi,sa,la,taa	फि,स,ल,ता
maa,taa,yon	मा,ता,ओं
paa,n	पा,याँ
dha,da,kaa,n,gi	ध,ड़,का,ऊँ,गी
1,1	1,9,1,8
ba,saa,yi	ब,सा,ई
ta,n,haa,yi	त,न,हा,ई
a,ga,n,vaa	अं,ग,न,वा
pa,she,maa	प,शे,माँ
gi,r,dhaa,ri	गि,र,धा,री
gu,n,gu,na,te	गु,न,गु,ना,ते
gi,n,ti	गि,न,ती
gu,n,gu,na,taa	गु,न,गु,ना,ता
gi,n,taa	गि,न,ता
gu,n,gu,na,ti	गु,न,गु,ना,ती
gi,n,te	गि,न,ते
ka,vi,yi,tri	क,वि,यि,त्री
na,shaa,di,n	ना,शा,दि,याँ
bi,chhu,aa	बि,छु,आ
raa,ja,ni,ti,ka	रा,ज,नी,ति,क
daa	दा,स्ताँ
di,non	दि,नों
gu,la,bu,le	गु,ल,बु,ले
so,o,r,daa,sa	सो,ओ,र,दा,स
chaa,ha,tein	चा,ह,तें
sa,taa,ye	स,ता,एँ
ka,ha,taa	क,ह,ता
fi,ta,r,ta	फ़ि,त,र,त
ja,ga,ma,gaa,ti	ज,ग,म,गा,ती
ja,ga,ma,gaa,te	ज,ग,म,गा,ते
mu,ma,ki,n	मु,म,कि,न
duu,ba,taa	डू,ब,ता
i,si,li,ye	इ,सी,लि,ए
la,gaa,yi	ल,गा,ई
ri,ma,jhi,ma	रि,म,झि,म
ma,ju,ma,daa,r	म,जु,म,दा,र
ka,ja,le	क,ज,ले
u,la,jhi	उ,ल,झी
pra,dhaa,n,ma,tri	प्र,धा,न,मं,त्री
yi,da,u,la,phi,tta,r	ई,द,उ,ल,फि,त्त,र
ba,ha,ki	ब,ह,की
ba,ha,ke	ब,ह,के
ba,ha,kaa	ब,ह,का
pyaa,r	प्या,र
ye,ka,da,ma	ए,क,द,म
pa,dhaa,yi	प,ढा,ई
yi,da,u,la,phi,tta,r	ई,द,उ,ल,फि,त्त,र
aa,ja,ka,la	आ,ज,क,ल
ha,vaa,yon	ह,वा,ओं
ha,vaa,o,n	ह,वा,ओ,न
bhaa,jaa,paa,yi	भा,जा,पा,ई
ba,ha,laa,te	ब,ह,ला,ते
ba,ha,laa,taa	ब,ह,ला,ता
pa,ga,le	प,ग,ले
ta,da,pe,gaa	त,ड़,पे,गा
pa,ga,laa	प,ग,ला
ta,da,pe,gi	त,ड़,पे,गी
pa,ga,li	प,ग,ली
raa,ma,cha,ndra	रा,म,चं,द्र
gu,da,gu,daa,ye	गु,द,गु,दा,ए
ba,r,si	ब,र,सी
ji,sa,pa,r	जि,स,प,र
bhaa,r,ti,ya	भा,र,ती,य
do,sau,sau	2,0,0
thu,ka,raa	ठु,क,रा
aa,sa,raa	आ,स,रा
thu,ka,raa,o	ठु,क,रा,ओ
ka,ha,laa,taa	क,ह,ला,ता
da,r,vaa,je	द,र,वा,जे
hu,sa,na,vaa,le	हु,स,ना,वा,ले
da,r,vaa,zaa	द,र,वा,ज़ा
da,r,vaa,je	द,र,वा,जे
maa,i,ya	मा,इ,या
ye,la,ke,ji	ए,ल,के,जी
aa,r,zu,yon	आ,र,ज़ु,ओं
pi,gha,la,taa	पि,घ,ल,ता
du,aa,yon	दु,आ,ओं
ma,ja,ri	मं,ज,री
ju,ma,ry	जु,म,र्
aa,za,maa,na	आ,ज़,मा,ना
aa,ja,maa,na	आ,ज,मा,ना
aa,za,maa,ne	आ,ज़,मा,ने
baa,va,raa	बा,व,रा
baa,vaa,re	बा,वा,रे
baa,va,re	बा,व,रे
baa,va,ri	बा,व,री
baa,va,re	बा,व,रे
chaa,vaa,i	चा,वा,इं
ta,n,haa,yi,yon	त,न,हा,ई,यों
ta,n,haa,i,yon	त,न,हा,इ,यों
ba,da,la,ti	ब,द,ल,ती
ba,da,la,taa	ब,द,ल,ता
ba,da,la,te	ब,द,ल,ते
pi,gha,la,ne	पि,घ,ल,ने
thaa,ka,re	ठा,क,रे
vi,kaa,sa,da	वि,का,स,खं,ड
ma,ha,boo,baa	म,ह,बू,बा
yi,da,u,la,phi,tta,r	ई,द,उ,ल,फि,त्त,र
kha,la,ba,li	ख,ल,ब,ली
jyaa,daa	ज्या,दा
n,r,ma	न,र,म
i,dau,r	इं,दौ,र
mu,sku,raa,n	मु,स्कु,रा,ऊँ
mu,sku,raa,o	मु,स्कु,रा,ओ
pra,ka,r,n	प्र,क,र,ण
sai,ti,sa,ven	सैं,ती,स,वें
ki,da,ma,ta	ख़ि,द,म,त
du,ni,ya,vaa,lo	दु,नि,या,वा,लो
gu,da,gu,daa,ti	गु,द,गु,दा,ती
ri,shte	रि,श्ते
pa,la,ke	प,ल,कें
pa,la,ka,da,sa	प,ल,क,द,स
ma,ya,khwaa,r	म,य,ख्वा,र
ba,ha,ka,ti	ब,ह,क,ती
ji,ve	जी,वे
jo,doo	जो,ड़ूँ
ba,da,li,yon	ब,द,लि,यों
vya,va,saa,sa	व्य,व,सा,स
ba,nsoo	ब,सूँ
kyaa,lon	ख़्या,लों
khya,lon	ख्या,लों
di,la,vaa,lon	दि,ल,वा,लों
bi,te	बी,ते
bi,te	बी,ते
si,kha,laa,ye,gaa	सि,ख,ला,ए,गा
taa,ri,ki,n	ता,री,कि,याँ
si,sa,ka,taa	सि,स,क,ता
be,va,faa,yi	बे,व,फ़ा,ई
be,va,faa,yi	बे,व,फा,ई
be,vaa,faa,yi	बे,वा,फ़ा,ई
u,pa,bho,kta,yon	उ,प,भो,क्ता,ओं
chhu,tti,n	छु,ट्टि,याँ
sa,ma,jhaa,ya	स,म,झा,या
sa,ma,jhaa,ye	स,म,झा,ये
sa,ma,jhaa,ye	स,म,झा,ए
chaa,haa	चा,हा
che,ha,re	चे,ह,रे
cha,ha,raa	च,ह,रा
che,ha,raa	चे,ह,रा
che,ha,re	चे,ह,रे
cha,ha,re	च,ह,रे
paa,ye	पा,एँ
frie,chaa,i,za	फ्रें,चा,इ,ज़
che,ha,ron	चे,ह,रों
traa,va,n,ko,r	ट्रा,व,ण,को,र
laa,n,gaa	ला,ऊँ,गा
di,la,jaa,ni	दि,ल,जा,नी
va,r,na	व,र,ना
sau,r,se,ni	सौ,र,से,नी
mu,sa,kaa	मु,स,का,वूँ
pa,ha,chaa,ne	प,ह,चा,ने
vo	वो
va	व
tha,ma,ka,r	था,म,क,र
ka,hoo	क,हूँ
ka,hu	क,हुँ
kaa,hu	का,हु
ba,r,saa,tein	ब,र,सा,तें
ki,ya	कि,या
raa,ja,ni,ti,ka	रा,ज,नी,ति,क
a,n,ho,ni	अ,न,हो,नी
pa,ha,chaa,n,te	प,ह,चा,न,ते
du,kha,n	दू,ख,न
ha,me	ह,में
ga,la,ti,yon	ग,ल,ति,यों
a,la,vi,daa	अ,ल,वि,दा
cho,r,ni	चो,र,नी
su,r,ji,ta	सु,र,जी,त
pa,da,ti	प,ड़,ती
ni,kha,daa	नि,ख,ड़ा
jaa,la,maa	जा,ल,माँ
ka,r,taa,r	क,र,ता,र
ta,nhaa,yi,yon	त,न्हा,ई,यों
ga,vaa,ye	गं,वा,ए
ga,vaa,yi	गं,वा,ई
ga,vaa,yi	गँ,वा,ई
ja,poo	ज,पूँ
ku,da,r,ta	कु,द,र,त
bhaa,ye,nge	भा,एँ,गे
gu,la,ba,da,n	गु,ल,ब,द,न
ka,r,va,ton	क,र,व,टों
cha,ta,kaa,na	च,ट,का,ना
ba,da,ta,mi,zi	ब,द,त,मी,ज़ी
pri,ya	प्रि,या
da,r,vaa,zaa	द,र,वा,ज़ा
a,va,sa,ron	अ,व,स,रों
dhu,n	धु,वाँ
pa,na,ho	प,ना,हो
gi,r,na	गि,र,ना
gi,r,ne	गि,र,ने
ha,ma,da,ma	ह,म,द,म
hu,ma,du,ma	हु,म,दू,म
ru,sa,vaa	रु,स,वा
ho,i,be	हो,इ,बे
r,hi,ma,pu,ri	र,हि,म,पु,री
bo,li,yo	बो,लि,यो
ba,r,sa,ti	ब,र,स,ती
ba,r,sa,te	ब,र,स,ते
ba,r,sa,taa	ब,र,स,ता
go,ri,ye	गो,रि,ए
cha,ta,ki	च,ट,की
shaa,khaa,ye	शा,खा,एँ
sa,koo	स,कूँ
be,gaa,ne	बे,गा,ने
sa,mbha,la,na	स,म्भ,ल,ना
swa,pa,ni,la	स्व,प,नि,ल
ka,ha,te,i,n	क,ह,ते,इ,न
ka,yi	क,ई
di,kha,taa	दि,ख,ता
tu,ta,ne	टू,ट,नें
ha,sa	हँ,स
li,kha,na	लि,ख,ना
ma,n,chaa,hi	म,न,चा,ही
a,au,r	अ,औ,र
va	व
ma,ha,fi,la	म,ह,फ़ि,ल
pa,ka,daa	प,क,ड़ा
pa,ka,de	प,क,डे
pa,ka,de	प,क,ड़े
ti,non	ती,नों
pa,ka,di	प,क,ड़ी
pa,ka,do	प,क,ड़ो
ma,n,mi,ta	म,न,मी,त
aa,di,vaa,si	आ,दि,वा,सी
me,ri	मे,री
me,i	में,इ
ta,r,nsoo	त,र,सूँ
to,doo	तो,ड़ूँ
swa,ya	स्व,यं
ni,rna,yon	नि,र्ण,यों
ka,ti,n	क,टि,याँ
pu,kaa,ru	पु,का,रूँ
to,de	तो,ड़े
saa,va,re	साँ,व,रे
gaa,n,gi	गा,ऊँ,गी
jaa,haa,ya,vaa,la	जा,हा,य,वा,ल
gu,ja,ri	गु,ज,री
mu,rjhaa,yi	मु,र्झा,ई
phu,aa,re	फु,आ,रे
ba,daa,maa	ब,दा,माँ
u,lle,kha,ni,ya	उ,ल्ले,ख,नी,य
ka,sa,me	क,स,में
la,la,chaa,ye	ल,ल,चा,ए
la,la,chaa,yi	ल,ल,चा,ई
pa,r,chhaa,yi,yaan	प,र,छा,ई,यां
bo,luu	बो,लूँ
u,se	उ,से
gi,r,dhaa,ri	गि,र,धा,री
su,laa,yuu,gi	सु,ला,ऊं,गी
se,vaa,ye	से,वा,एँ
aa,shi,ya,na	आ,शि,या,ना
na,ga,ma,ni	ना,ग,म,नी
i,ta,haa,n	इं,त,हा,न
sa,ma,jhaa,ye	स,म,झा,ये
sa,ma,jhaa,ye	स,म,झा,ए
fi,ru	फ़ि,रूँ
di,n,raa,yi	दि,न,रा,ई
maa,ri,ya	मा,रि,या
bu,jhaa,ye	बु,झा,ए
bu,jhaa,yi	बु,झा,ई
bu,jhaa,o	बु,झा,ओ
ni,ga,ha,baa	नि,ग,ह,बाँ
chuu,ma,ne	चू,म,ने
kau,n,se	कौ,न,से
ha,da,ka,mpa	ह,ड़,क,म्प
bu,jhe	बु,झे
ga,ha,raa,i,yon	ग,ह,रा,इ,यों
ja,la,na	ज,ल,ना
sa,ha,yo,ga	स,ह,यो,ग
sa,ma,jhe,nge	स,म,झें,गे
aa,ye,gaa	आ,ए,गा
aa,ye,gaa	आ,ये,गा
ta,da,pe,nge	त,ड़,पें,गे
ya	या
de,khuu	दे,खूँ
ya	या
n	याँ
ya	या
chha,la,kaa,ya	छ,ल,का,या
si,taa,re	सि,ता,रे
ka,haa,ni,n	क,हा,नि,याँ
gu,la,si,n	गु,ल,सि,ताँ
be,ka,raa,ri,yon	बे,क,रा,रि,यों
jaa,yuu	जा,ऊं
ye	ये
ka,va,ri,n	क,व,रि,याँ
ye	ये
ba,taa,n,gi	ब,ता,ऊँ,गी
chhu,paa,o	छु,पा,ओ
chhu,paa,n	छु,पा,ऊँ
ki,la,kaa,ri	कि,ल,का,री
ni,shaa,ni,n	नि,शा,नि,याँ
jaa,te	जा,ते
sa,da,sya	स,द,स्य
pre,r,na	प्रे,र,णा
mu,sa,kaa,n	मु,स,का,ऊँ
mu,skaa,ye	मु,स्का,ए
ma,ha,ka,ne	म,ह,क,ने
di,ya,r	डि,य,र
mu,skaa,o	मु,स्का,ओ
mu,skaa,yi	मु,स्का,ई
mu,sa,kaa,yi	मु,स,का,ई
sha,r,na,ga,ta,ma	श,र,णा,ग,त,म
daa,le	डा,ले
raa,ja,swa	रा,ज,स्व
jhi,la,mi,laa,ye	झि,ल,मि,ला,ये
ta,sa,vi,r	त,स,वी,र
kha,ba,ron	ख,ब,रों
su,ba,ha	सु,ब,ह
daa	दा,स्ताँ
daa,staa,n	दा,स्ता,न
daa,sa,n	दा,स,ताँ
sa,ja,n,vaa	स,ज,न,वा
bu,la,bu,la	बु,ल,बु,ल
r,vaa,ni,n	र,वा,नि,याँ
a,va,he,la,na	अ,व,हे,ल,ना
di,la,daa,ri	दि,ल,दा,री
ha,la,kaa,n	ह,ल,का,न
sa,ma,sya,yon	स,म,स्या,ओं
ghe,ye,re	घे,ए,रे
cho,ti,n	चो,टि,याँ
gyaa,r,ha,vi	ग्या,र,ह,वीं
pa,ha,n,ti	प,ह,न,ती
r,n,ni,ti	र,ण,नी,ति
chu,raa,yuu	चु,रा,ऊं
ru,pa,re,khaa	रु,प,रे,खा
ju,ga,nu	जु,ग,नू
ju,ga,ni	जु,ग,नी
ju,ga,nuun	जु,ग,नूं
a,ro,vi,kaa,sa,n	अ,रो,वि,का,स,न
bo,yi	बो,ई
bi,kha,ri	बि,ख,री
bo,ye	बो,ए
pa,ga,di	प,ग,ड़ी
ya,da,gaa,r	या,द,गा,र
la,da,ki,yon	ल,ड़,कि,यों
vai,shi,sht,taa,yon	वै,शि,ष्ट,ता,ओं
aa,yi,daa	आ,ई,दा
bi,chha,da,te	बि,छ,ड़,ते
ma,ha,kaa,ti	म,ह,का,ती
su,ni,yo	सु,नि,यो
r,n	र,वाँ
kha,n,kaa,ye,nge	ख,न,का,एं,गे
jaa,noo	जा,नूँ
ha,la,cha,la	ह,ल,च,ल
ma,ha,kaa,yuu	म,ह,का,ऊं
sa,ma,jha,ka,r	स,म,झ,क,र
pa,r,chhaa,yi	प,र,छा,ईं
u,the	उ,ठे
sa,jaa,n,gaa	स,जा,ऊँ,गा
ma,ja,boo,ri,n	म,ज,बू,रि,याँ
sa,jaa,yuu,gi	स,जा,ऊं,गी
u,ta,raa	उ,त,रा
pa,ha,noo	प,ह,नूँ
ru,n,jhu,n	रु,न,झु,न
hau,sa,laa	हौ,स,ला
me,ye,ri	मे,ए,री
sa,taa,ti	स,ता,ती
ma,ha,ka,taa	म,ह,क,ता
be,va,faa,yi	बे,व,फ़ा,ई
chaa,sha,ni	चा,श,नी
ka,li,n	क,ली,याँ
ba,na,n	ब,ना,ऊँ
la,pa,kaa	ल,प,का
ma,ha,rbaa,ni,n	म,ह,र्बा,नि,याँ
ma,ha,taa,ba	म,ह,ता,ब
pa,r,chhaa,yi	प,र,छा,ईं
sa,ma,jhe,gaa	स,म,झे,गा
la,fa,don	ल,फ़,ड़ों
sa,ma,jhu	स,म,झूँ
ji,ta,ne	जी,त,ने
do,sau,sau	2,0,0
do,sau,do	2,0,2
	c,a,n,n,o,t, ,u,n,d,e,r,s,t,a,n,d
paa,i,ye,gaa	पा,इ,ये,गा
kaa,rya,kra,mon	का,र्य,क्र,मों
u,thaa,ye,gi	उ,ठा,ए,गी
ba,da,na,ma	ब,द,ना,म
bhi,go,yi	भी,गो,ई
so,chi,ye	सो,चि,ए
tu,ma,ne	तु,म,ने
mu,jha,ko	मु,झ,को
ma,ja,nu	म,ज,नू
baa,i,sa	बा,इ,स
baa,raa	बा,रा
mi,le	मि,ले
baa,raa	बा,रा
mi,le	मि,लें
mi,le	मि,ले
tu,la,ti	तु,ल,ती
ma,ja,noo	म,ज,नूँ
aa,rma,ga	आ,र्म,स्ट्रिं,ग
ba,chaa,o	ब,चा,ओ
sa,r,phi,raa	स,र,फि,रा
paa,n,gi	पा,ऊँ,गी
paa,n,gaa	पा,ऊँ,गा
bu,la,bu,lon	बु,ल,बु,लों
bu,la,bu,le	बु,ल,बु,ले
bu,la,bu,le	बु,ल,बु,लें
jaa,n,ti	जा,न,ती
va,faa,o	व,फ़ा,ओ
jaa,n,taa	जा,न,ता
jaa,n,te	जा,न,ते
jaa,n,ti	जा,न,ती
dho,la,na	ढो,ल,ना
do,la,na	डो,ल,ना
ma,kha,ma,la	म,ख,म,ल
ka,da,raa	क,द,राँ
shi,va,pu,ri	शि,व,पु,री
i,ta,ni	इ,त,नी
fi,kra	फ़ि,क्र
chaa,sa,kaa	चा,स,का
hai,a,me,ri,kaa	है, ,अ,मे,रि,का
sa,ma,jha,taa	स,म,झ,ता
sa,da,bu,ddh	स,द,बु,द्ध
chhaa,tra,yon	छा,त्रा,ओं
na,ye	ना,ए
na,yi	ना,ई
ye,va	ए,वं
jhuu,ma,ne	झू,म,ने
ga,tha,ba,dha,n	ग,ठ,बं,ध,न
pa,chha,taa,ye,gi	प,छ,ता,ए,गी
fi,zaa,yon	फ़ि,ज़ा,ओं
jaa,o,nge	जा,ओ,गे
jaa,o,gi	जा,ओ,गी
aa,shi,n	आ,शि,याँ
pa,rba,ton	प,र्ब,तों
pa,ha,re	प,ह,रे
pa,ta,na	प,ट,ना
ga,vaa,yi	गँ,वा,ई
mu,jha,pe	मु,झ,पे
aa,ya	आ,य
a,khaa	अ,खाँ
pa,la,ke	प,ल,कें
ma,laa,i	म,ला,इ
ma,laa,yi	म,ला,ई
shi,qa,vaa	शि,क़,वा
hi,du,staa,n	हिं,दु,स्ता,न
pa,ta,vaa,r	प,त,वा,र
u,thaa,n,gi	उ,ठा,ऊँ,गी
ru,sa,vaa,i,n	रु,स,वा,इ,याँ
ha,sa,r,ton	ह,स,र,तों
va,r,daa,n	व,र,दा,न
gu,n,gu,na,o,nge	गु,न,गु,ना,ओ,गे
ju,baa,ya,daa	जु,बा,य,दा
ri,sha,te	रि,श,ते
ja,sa,baa,ta	ज,स,बा,त
yi,da,u,la,phi,tta,r	ई,द,उ,ल,फि,त्त,र
kaa,ma,kaa,ja	का,म,का,ज
sa,ma,jhaa,yuu,gi	स,म,झा,ऊं,गी
mi,laa,n	मि,ला,ऊँ
maa,goo	माँ,गूँ
vi,ro,dhi,yon	वि,रो,धि,यों
paa,ye	पा,एं
r,kha,ka,r	र,ख,क,र
kaa,r,n	का,र,वाँ
du,a,nni	दु,अ,न्नी
ru,su,vaa,yi	रु,सु,वा,ई
ga,va	गाँ,व
gaa,ye	गा,ए
gaa,yi	गा,ई
ga,va	गाँ,व
gaa,o	गा,ओ
ma,ja,nu	म,ज,नू
saa,ma,yi,ka	सा,म,यि,क
dhoo,dha,ti	ढूँ,ढ,ती
ma,r,ma,ri	म,र,म,री
ha,ta,ke	ह,ट,के
khi,laa,ye	खि,ला,ए
khi,laa,o	खि,ला,ओ
thi,r,ka,na	थि,र,क,ना
si,la,si,laa	सि,ल,सि,ला
gha,ba,raa,o	घ,ब,रा,ओ
gha,ba,raa,yi	घ,ब,रा,ई
gha,ba,raa,ye	घ,ब,रा,ए
bhaa,r,ta	भा,र,त
pi,si,si	पी,सी,सी
la,gaa,yi	ल,गा,ई
pa,ha,chaa,noo	प,ह,चा,नूँ
cha,laa,ye	च,ला,ए
cha,laa,yi	च,ला,ई
cha,laa,o	च,ला,ओ
jaa,n	जा,न
ju,baa	जु,बाँ
mi,khaa,i,la	मि,खा,इ,ल
r,kha,taa	र,ख,ता
i,ka,da,ma	इ,क,द,म
yi,da,u,la,phi,tta,r	ई,द,उ,ल,फि,त्त,र
r,kha,ni	र,ख,नी
r,kha,ne	र,ख,ने
r,kha,na	र,ख,ना
saa,ma,ne	सा,म,ने
maa,n,ke	मा,न,के
gha,ba,raa,taa	घ,ब,रा,ता
gha,ba,raa,ti	घ,ब,रा,ती
dha,da,kaa,ye	ध,ड़,का,ये
dha,da,kaa,ya	ध,ड़,का,या
mu,sku,raa,ye	मु,स्कु,रा,ए
mu,sku,raa,o	मु,स्कु,रा,ओ
mu,sku,raa,yi	मु,स्कु,रा,ई
mu,ska,raa,yi	मु,स्क,रा,ई
i,sa,se	इ,स,से
sa,ma,jha,na	स,म,झ,ना
pa,cha,de	प,च,ड़े
swa,da,taa,vaa,di	स्व,छं,द,ता,वा,दी
mu,r,gi	मु,र,गी
a,va,taa,r	अ,व,ता,र
ba,r,sa,ke	ब,र,स,के
chi,da,chi,daa	चि,ड़,चि,ड़ा
mu,r,jhaa,ye	मु,र,झा,ए
ga,ha,ri	ग,ह,री
ga,ha,raa	ग,ह,रा
ga,ha,n	ग,ह,न
ga,ha,re	ग,ह,रे
sa,ma,jhaa,yuu,gi	स,म,झा,ऊं,गी
ha,zaa,ro	ह,ज़ा,रो
vi,dhaa,n,sa,bhaa	वि,धा,न,स,भा
jhu,koo	झु,कूँ
ro,ye,gaa	रो,ए,गा
ro,ye,gi	रो,ए,गी
pa,taa	प,ता
i,n,kaa	इ,न,का
sha,r,maa,o,gi	श,र,मा,ओ,गी
sha,r,maa,o,nge	श,र,मा,ओ,गे
phi,r,ke	फि,र,के
u,sa,ki	उ,स,की
u,sa,ke	उ,स,के
u,sa,ko	उ,स,को
u,sa,ka	उ,स,क
u,sa,kaa	उ,स,का
u,sa,ki	उ,स,की
u,sa,ke	उ,स,के
bu,laa,yi	बु,ला,ई
bu,laa,ya	बु,ला,य
me,ha,r,baa,n	मे,ह,र,बा,न
me,ha,r,baa	मे,ह,र,बाँ
ba,r,ka,raa,r	ब,र,क,रा,र
ni,ka,la,ti	नि,क,ल,ती
ni,ka,la,taa	नि,क,ल,ता
ni,ka,la,te	नि,क,ल,ते
ha,ma,ne	ह,म,ने
ro,sha,ni	रो,श,नी
laa,yuu	ला,ऊं
ta,da,paa,va,ta	त,ड़,पा,व,त
chu,pa,ke	चु,प,के
u,daa,n,gi	उ,ड़ा,ऊँ,गी
sa,di,n	स,दि,याँ
aa,r,ji,vi	आ,र,जी,वी
1,7,3	1,9,7,3
sa,ma,jhaa,yuu	स,म,झा,ऊं
bhaa,r,ti,ya	भा,र,ती,य
kaa,mo,shi,n	ख़ा,मो,शि,याँ
ni,shaa,ni,n	नि,शा,नि,याँ
cha,laa,ye	च,ला,ए
pa,raa,yi	प,रा,ई
sa,ma,jhaa,ya	स,म,झा,या
dha,da,ka,na	ध,ड़,क,ना
ta,r,saa	त,र,सा
jaa,ye	जा,ये
jaa,ye	जा,एँ
jaa,ye	जा,येँ
sa,ja,taa	स,ज,ता
baa,la,maa	बा,ल,मा
ba,la,maa	ब,ल,मा
sa,ja,ti	स,ज,ती
di,laa,yi	दि,ला,ई
mi,khaa,i,la	मि,खा,इ,ल
ku,mha,laa,ye	कु,म्ह,ला,ए
baa,la,mi,tra	बा,ल,मि,त्र
ma,ha,phi,le	म,ह,फि,लें
traa,va,n,ko,r	ट्रा,व,ण,को,र
sai,n	सै,याँ
aa,i,ye	आ,इ,ये
	c,a,n,n,o,t, ,u,n,d,e,r,s,t,a,n,d
saa,va,re	साँ,व,रे
saa,va,ri	साँ,व,री
ba,ta,laa,n,gi	ब,त,ला,ऊँ,गी
ju,la,mi	जु,ल,मी
mu,r,jhaa,ye	मु,र,झा,ए
ye,ka,ju,ta	ए,क,जु,ट
ha,ma,saa,ya	ह,म,सा,या
ni,kaa,luu	नि,का,लूँ
jaa,vi,daa	जा,वि,दाँ
ha,ma,se	ह,म,से
ba,r,se,nge	ब,र,सें,गे
ma,n,chaa,hi	म,न,चा,ही
ki,n,se	कि,न,से
mi,ta,na	मि,ट,ना
mi,ta,ne	मि,ट,ने
cha,mpaa,yi	च,म्पा,ई
yo,ja,na,yon	यो,ज,ना,ओं
too	तू,फ़ाँ
u,thaa,i,ye	उ,ठा,इ,ये
ba,taa,n	ब,ता,ऊँ
bu,jhaa,n,gi	बु,झा,ऊँ,गी
bu,jhaa,yuu,gi	बु,झा,ऊं,गी
bi,chha,da,te	बि,छ,ड़,ते
vi,chaa,r,kon	वि,चा,र,कों
ti,ya	टि,न्सि,या
pa,ya,le	प,या,ले
jaa,ye,gi	जा,ए,गी
jaa,ye,gaa	जा,ए,गा
su,la,jhaa,ne	सु,ल,झा,ने
raa,ja,swa	रा,ज,स्व
raa,ja,swa	रा,ज,स्व
la,ha,raa,ya	ल,ह,रा,य
ka,mpa,ni,n	क,म्प,नि,याँ
ni,r,dha,n	नि,र,ध,न
mu,sa,kaa,ye,gi	मु,स,का,ए,गी
va,da,n	वं,द,न
a,su,va,n	अं,सु,व,न
a,va,sa,r	अ,व,स,र
aa,sa,raa	आ,स,रा
aa,sa,re	आ,स,रे
a,ga,na,yi	अं,ग,ना,ई
baa,da,shaa,ha	बा,द,शा,ह
jhi,la,mi,laa,te	झि,ल,मि,ला,ते
pi,ye,nge	पि,एँ,गे
pa,r,chha,i,ya	प,र,च्छा,इ,या
sa,r,kaa,ron	स,र,का,रों
chhu,o	छु,ओ
wa	वॉ
r,n	र,वाँ
chhu,ye	छु,ए
aa,ja,ka,la	आ,ज,क,ल
la,gaa,ye,gaa	ल,गा,ए,गा
maa,r,vaa	मा,र,वा
a,ha,saa,sa	अ,ह,सा,स
ye,ha,saa,sa	ए,ह,सा,स
pa,ha,n,ka,r	प,ह,न,क,र
ni,bhaa,n,gaa	नि,भा,ऊँ,गा
pa,ra,tu	प,रं,तु
a,fa,sa,r	अ,फ,स,र
gha,na	घा,ना
aa,ye,nge	आ,एँ,गे
aa,ye,nge	आ,यें,गे
aa,ye,nge	आ,एं,गे
chaa,ha,ton	चा,ह,तों
aa,ye,gi	आ,एं,गी
ma,ha,ka,taa	म,ह,क,ता
dha,da,kaa,o,nge	ध,ड़,का,ओ,गे
aa,ma,ba,r	आ,म,ब,र
tu,jha,ko	तु,झ,को
cha,mkaa,ye	च,म्का,ए
ja,ya,va,ti	ज,य,वं,ती
cha,dra,be,n	चं,द्रा,बे,न
fi,zaa,ye	फ़ि,ज़ा,एँ
bo,la,na	बो,ल,ना
pa,chha,taa,ye,gi	प,छ,ता,ये,गी
ja,haa	ज,हाँ
ba,ta,laa,i,ye	ब,त,ला,इ,ये
ve,kha,ya	वे,ख,या
ye,ma,bi,ye	ए,म,बी,ए
de,khuu	दे,खूँ
de,khu	दे,खु
la,gaa,n,gaa	ल,गा,ऊँ,गा
aa,ta,ka,vaa,di,yon	आ,तं,क,वा,दि,यों
a,la,vi,daa	अ,ल,वि,दा
la,gaa,yuu,gi	ल,गा,ऊं,गी
vi,raa	वी,राँ
pau,da,vaa,la	पौ,ड,वा,ल
chu,bho,yi	चु,भो,ई
va,ha,tu,la	व,ह,तु,ल
jhaa,bu,aa	झा,बु,आ
aa,su,yon	आँ,सु,ओं
ha,ma,raa,hi	ह,म,रा,ही
sa,ha,mi	स,ह,मी
a,r,maa,non	अ,र,मा,नों
pyaa	प्या
pa,ya,r	प,या,र
haa	हाँ
hai	है
pa,la,kon	प,ल,कों
si,la,vaa,n,gaa	सि,ल,वा,ऊँ,गा
ta,nhaa,yi,yaan	त,न्हा,ई,यां
ta,n,haa,i,yaan	त,न,हा,इ,यां
ta,n,haa,yi,yaan	त,न,हा,ई,यां
ta,nhaa,i,yaan	त,न्हा,इ,यां
fu,r,sa,ton	फ़ु,र,स,तों
ba,ha,laa,o	ब,ह,ला,ओ
du,aa,r	दु,आ,र
laa,ye	ला,एं
su,n,ke	सु,न,के
raa,za,daa	रा,ज़,दाँ
u,la,jhi	उ,ल,झी
pa,ha,n	प,ह,न
swa,pa,ni,la	स्व,प,नि,ल
a,fa,saa,na	अ,फ़,सा,ना
a,fa,saa,ne	अ,फ़,सा,ने
gha,r,vaa,li	घ,र,वा,ली
n,ga	ताँ,गाँ
jaa,i,ye,gaa	जा,इ,ये,गा
phi,r,ne	फि,र,ने
daa	दा,स्ताँ
aa,ne,vaa,le	आ,ने,वा,ले
lo,ri,n	लो,रि,याँ
la,ha,raa,taa	ल,ह,रा,ता
be,taa,bi,n	बे,ता,बि,याँ
a,daa,ye	अ,दा,एं
gaa,yuu,gaa	गा,ऊं,गा
daa,ya,re,cto	डा,य,रे,क्ट
ma,n,maa,ni	म,न,मा,नी
ja,ga,ma,ga	ज,ग,म,ग
be,di,n	बे,ड़ि,याँ
de,kha,ti	दे,ख,ती
de,kha,te	दे,ख,ते
thu,ma,kaa	ठु,म,का
yuu	यूँ
ta,r,kaa,ri	त,र,का,री
gu,la,boo,taa	गु,ल,बू,टा
haa,rmo,ni,ya,ma	हा,र्मो,नि,य,म
chuu,di,n	चू,ड़ि,याँ
chu,di,n	चु,ड़ि,याँ
da,r,baa,r	द,र,बा,र
gaa,yuu,gaa	गा,ऊं,गा
lo,ka,sa,bhaa	लो,क,स,भा
u,ng,li,n	उ,न्ग,लि,याँ
baa,i,laa	बा,इ,ला
sau,sau	4,0,0
daa,ya,re	दा,य,रे
ba,n,vaa,ye,nge	ब,न,वा,एँ,गे
a,ja,n,bi	अ,ज,न,बी
sa,ma,jhaa,te	स,म,झा,ते
sa,ma,jhaa,ti	स,म,झा,ती
la,ha,raa,ye	ल,ह,रा,ये
la,ha,raa,ye	ल,ह,रा,ए
chho,ri,ye	छो,रि,ए
r,ha,na	र,ह,ना
pi,taa,yon	पि,ता,ओं
ru,laa,ye	रु,ला,एं
n,hin	न,हीं
chaa,hoo	चा,हूँ
cha,hoo	च,हूँ
shi,ka,ve	शि,क,वे
shi,ka,vaa	शि,क,वा
la,ha,ren	ल,ह,रें
ba,da,maa,shi	ब,द,मा,शी
ba,na,yuu,gaa	ब,ना,ऊं,गा
ba,na,n,gaa	ब,ना,ऊँ,गा
ru,ka,na	रु,क,ना
sa,chchaa,i,yon	स,च्चा,इ,यों
chho,doo	छो,ड़ूँ
ni,gaa	नि,गा,होँ
ha,nsoo	ह,सूँ
pa,ha,chaa,noo	प,ह,चा,नूँ
be,taa,bi,n	बे,ता,बि,याँ
za,baa	ज़,बाँ
ka,taa,ksha	क,टा,क्ष
ma,ta,vaa,laa	म,त,वा,ला
ja,da,te	ज,ड़,ते
saa,ma,na	सा,म,ना
saa,ma,ne	सा,म,ने
raa,shtra,ma,da,la	रा,ष्ट्र,मं,ड,ल
shi,ka,ve	शि,क,वे
5,5	5,4,5
bi,ma,laa	बि,म,ला
sa,ha,laa,ye	स,ह,ला,एं
sa,r,kaa,ri	स,र,का,री
ji,sa,mon	जि,स,मों
mu,aa	मु,आ
mu,yi	मु,ई
ha,ma,ne	ह,म,ने
ha,ma,ne	ह,म,नें
do,nge	दो,गे
a,va,ga,ta	अ,व,ग,त
shu,ru,aa,ta	शु,रु,आ,त
chhaa,von	छाँ,वों
go,ri	गो,री
ye,n	ए,न
r,ga,do,nge	र,ग,ड़ो,गे
dha,n,ba,la	ध,न,ब,ल
sa,r,kaa,ron	स,र,का,रों
so,ha,ni,ye	सो,ह,नि,ए
daa,ya,raa	दा,य,रा
ji,ta,ne	जी,त,ने
ji,ta,na	जी,त,ना
jhu,ka,na	झु,क,ना
chu,n,nu	चु,न,नु
jhu,ka,ne	झु,क,ने
chho,da,na	छो,ड़,ना
si,la,vaa	सि,ल,वा
u,sa,se	उ,स,से
khaa,taa	खा,ता
ro,ja,gaa,r	रो,ज,गा,र
vi,r,ja,n	वि,र,ज,न
ba,r,son	ब,र,सों
ha,ma,da,ma	ह,म,द,म
pa,la,kon	प,ल,कों
sa,r,go,shi	स,र,गो,शी
phu,ta,la	फु,ट,बॉ,ल
nu,ka,saa,n	नु,क,सा,न
mu,skaa,ye	मु,स्का,एं
ka,ha,taa	क,ह,ता
ro,yi	रो,ई
ro,ye	रो,ए
jhuu,ma,kaa	झू,म,का
jhuu,ma,ke	झू,म,के
ta,n,ke	त,न,के
maa,r,n	मा,र,न
pa,ka,da,ka,r	प,क,ड़,क,र
ma,ha,boo,ba	म,ह,बू,ब
a,ka,don	आं,क,ड़ों
a,dhya,ya,n	अ,ध्य,य,न
n,zaa,re	न,ज़ा,रे
nau,ka,ri,n	नौ,क,रि,याँ
khu,sa,ki	खु,स,की
pri,ta,ma	प्री,त,म
r,maa,yi	र,मा,ई
sa,gi,ta,shai,li	सं,गी,त,शै,ली
ha,si,na,ye	ह,सी,ना,एँ
ba,da,li,n	ब,द,लि,याँ
pa,ha,na,ye,gaa	प,ह,ना,ए,गा
kaa,ma,ya,ba	का,म,या,ब
mu,jha,se	मु,झ,से
jo,khuu	जो,खूँ
ka,ga,na	कँ,ग,ना
ka,ga,na	कं,ग,ना
u,n,kaa	उ,न,का
di,r	दि,र
jaa,ye	जा,एं
jaa,ye,n	जा,ए,न
ta,n,ma,n	त,न,म,न
ho,thon	हों,ठों
ta,n,haa,yi	त,न,हा,ई
ta,nhaa,yi	त,न्हा,ई
ka,ma,ba	क,म,ब,ख़्त
chhu,paa,n,gaa	छु,पा,ऊँ,गा
sha,ta,ra,ja	श,त,रं,ज
aa,za,maa,ne	आ,ज़,मा,ने
r,ha,ba,r	र,ह,ब,र
saa,i,ka,la	सा,इ,क,ल
di,la,vaa,laa	दि,ल,वा,ला
di,la,vaa,le	दि,ल,वा,ले
yuu	यूँ
	युँ
di,la,vaa,li	दि,ल,वा,ली
kaa,r,n	ख़ा,र,वाँ
kaa,r,n	का,र,वाँ
chho,da,ti	छो,ड़,ती
chho,da,taa	छो,ड़,ता
ma,cha,la,na	म,च,ल,ना
la,la,chaa,yi	ल,ल,चा,ई
ga,li,n	ग,लि,याँ
hau,sa,laa	हौ,स,ला
la,la,chaa,ye	ल,ल,चा,ए
la,la,chaa,ye	ल,ल,चा,ये
paa,ye,nge	पा,एं,गे
a,ka,da,ti	अ,क,ड़,ती
thu,ka,raa,taa	ठु,क,रा,ता
gu,n,gu,na,ti	गु,न,गु,ना,ती
paa,o,nge	पा,ओ,गे
ma,n,mo,ha,n	म,न,मो,ह,न
ta,ka,raa,na	ट,क,रा,ना
ta,r,nsoo	त,र,सूँ
di,khaa,yuu	दि,खा,ऊं
a,r,vi,nda	अ,र,वि,न्द
hai	है
cha,ma,kaa,ya	च,म,का,या
luu	लूँ
poo,chhuu	पू,छूँ
ja,sa,be,la	ज,स,बे,ल
pa,sa,li	प,स,ली
ba,ga,lo	बँ,ग,लो
paa,ve	पा,वे
sa,r,taa,ja	स,र,ता,ज
ba,taa,ye	ब,ता,एं
ji,ta,ne	जी,त,ने
ye	ए,न्ड्र्यू
r,n,gaa,to	र,न,गा,तो
lu,taa,n,gi	लु,टा,ऊँ,गी
du,ni,n	दू,नि,याँ
du,ni,n	दु,नि,याँ
du,ni,ya	दु,नि,या
ghoo,ma,taa	घू,म,ता
pu,r,vai,ya	पु,र,वै,या
ghoo,ma,ti	घू,म,ती
pa,ka,daa,yi	प,क,ड़ा,ई
ni,la,ba,n	नि,लं,ब,न
ma,hu,ye	म,हु,ए
ba,ti,n	ब,ति,याँ
ba,tau,r	ब,तौ,र
chu,raa,n,gi	चु,रा,ऊँ,गी
ha,vaa,yon	ह,वा,ओं
va,llaa	व,ल्ला
a,ta,sta,la	अं,त,स्त,ल
vi,dhaa,n,sa,bhaa	वि,धा,न,स,भा
sha,r,mi,li	श,र,मी,ली
ni,ka,li	नि,क,ली
ni,ka,lo	नि,क,लो
ni,ka,laa	नि,क,ला
ni,kaa,laa	नि,का,ला
ni,ka,le	नि,क,ले
saa,da,gi	सा,द,गी
ye,ha,da	ए,ह,द
la,ga,ne	ल,ग,ने
daa	दा,स्ताँ
mi,laa,ye	मि,ला,एँ
sa,da,son	स,द,स्यों
sa,gi,n	सं,गी,न
chu,raa,ye,nge	चु,रा,एं,गे
sa,r,kaa	स,र,का
ga,tha,ba,dha,n	ग,ठ,बं,ध,न
sa,r,kaa,r	स,र,का,र
sa,r,kaa,ron	स,र,का,रों
ba,cha,na	ब,च,ना
kaa,rya,la,ya	का,र्या,ल,य
pa,ha,chaa,n,te	प,ह,चा,न,ते
sa,r,ha,da	स,र,ह,द
la,ha,raa,ye,nge	ल,ह,रा,एं,गे
la,ga,ti	ल,ग,ती
sa,khya	सं,ख्या
ba,ba,lu	ब,ब,लू
sa,hoo	स,हूँ
jaa,yuu,gaa	जा,ऊं,गा
jaa,n,gaa	जा,ऊँ,गा
haa	हाँ
haa,uu	हा,ऊ
haa,u	हा,उ
haa,ya	हा,य
haa,i	हा,इ
haa	हा
haa	हाँ
haa	हा
haa,ye	हा,ए
u,thaa,yi	उ,ठा,ई
u,thaa,o	उ,ठा,ओ
chaa,hoo	चा,हूँ
su,yi	सु,ई
ba,r,son	ब,र,सों
ma,ha,boo,bon	म,ह,बू,बों
ni,kha,r,ne	नि,ख,र,ने
ni,kha,r,na	नि,ख,र,ना
sa,jaa,yi	स,जा,ई
a,dhi,kaa,ri,yon	अ,धि,का,रि,यों
aa,li,gi,n	आ,लिं,गि,न
jhi,la,mi,laa,ye	झि,ल,मि,ला,ए
gu,zaa,r,taa	गु,ज़ा,र,ता
i,ga	फ़्ला,इं,ग
khe,va,di,n	खे,व,ड़ि,याँ
ru,baa,yi	रु,बा,ई
ha,vaa,ye	ह,वा,एं
ka,r,luu	क,र,लूँ
go,laa,i,yaan	गो,ला,इ,यां
i,sa,ne	इ,स,ने
i,n,saa,n	इ,न,सा,न
i	इ,न्साँ
i,n,saa	इ,न,सां
i,saa,n	इं,सा,न
i	इ,न्साँ
u,n,me	उ,न,में
mu,ka,r,taa	मु,क,र,ता
mu,ka,r,te	मु,क,र,ते
raa,laa,re	रा,ज्दु,ला,रे
li,da	बॉ,ली,वु,ड
pa,ti,n	प,ति,याँ
i,lti,zaa,ye	इ,ल्ति,ज़ा,एं
ba,na,yuu	ब,ना,ऊं
gaa,n	गा,ऊँ
r,cha,na	र,च,ना
baa,rg,li	बा,र्ग,ली
chha,la,kaa,ye	छ,ल,का,एं
jhaa,li	झा,ली
aa,gaa	आ,गा
ba,haa,raa	ब,हा,राँ
ma,ta,la,bi	म,त,ल,बी
daa,ya,re,cto	डा,य,रे,क्ट
sa,koo	स,कूँ
cha,da,n	चं,द,न
aa,shi,n	आ,शि,याँ
la,gaa,o,nge	ल,गा,ओ,गे
la,ha,la,haa	ल,ह,ल,हा
chuu,di,n	चू,ड़ि,याँ
pa,he,li,n	प,हे,लि,याँ
ha,ma,raa,hi	ह,म,रा,ही
a,ga,daa,yi	अं,ग,ड़ा,ई
ta,ka,di,r	त,क,दी,र
ba,r,khaa	ब,र,खा
laa	ला
laa,ye	ला,ये
laa,yi	ला,ई
laa,ye	ला,ए
ba,taa,li,ya,n	ब,टा,लि,य,न
hu	हुं
paa,ta,li,pu,tra	पा,ट,लि,पु,त्र
sa,ma,jho	स,म,झो
sa,ma,jhaa	स,म,झा
ku,r,baa,n	कु,र,बा,न
qu	क़ु,र्बाँ
qu,r,baa,n	क़ु,र,बा,न
sa,ma,jhe	स,म,झे
sa,ma,jhi	स,म,झी
sa,ma,jho	स,म,झो
pra,dhaa,n,ma,tri	प्र,धा,न,मं,त्री
cha,r,n	च,र,वाँ
thu,ka,raa,n	ठु,क,रा,ऊँ
sa,jaa,ye	स,जा,एँ
jaa,na	जा,ना
fu,r,qa,ta	फ़ु,र,क़,त
di,la,ru,baa	दि,ल,रु,बा
di,la,ru,baa	दि,ल,रू,बा
bi,ga,di	बि,ग,ड़ी
i,sa,li,ye	इ,स,लि,ए
i,sa,li,ye	इ,स,लि,ये
ru,swaa,yi	रु,स्वा,ई
ru,sa,vaa,yi	रु,स,वा,ई
sa,ja,daa	स,ज,दा
maa,ya,n,ga,ri	मा,या,न,ग,री
pa,te	प,ते
ba,cha,pa,n	ब,च,प,न
ka,ha,laa,ye,nge	क,ह,ला,एं,गे
a,n,de,khaa	अ,न,दे,खा
ba,dho,tta,ri	ब,ढ़ो,त्त,री
cha,ma,ka,na	च,म,क,ना
ya,ro	या,रो
ju,baa,ya,daa	जु,बा,य,दा
pa,r,vaa	प,र,वा
ka,r,taa	क,र,ता
ma,ta,daa,taa	म,त,दा,ता
ni,ka,luu	नि,क,लूँ
gu,ru,bhaa,yi	गु,रु,भा,ई
du,la,haa	दु,ल,हा
a,llaa	अ,ल्ला
n,ga,ron	न,ग,रों
ku,rsi,n	कु,र्सि,याँ
ka,maa,yi	क,मा,ई
ba,ha,r,haa,la	ब,ह,र,हा,ल
pu,r,vaa,yi	पु,र,वा,ई
ke,ndri,ta	के,न्द्रि,त
ma,ja,boo,ri	म,ज,बू,री
aa,pa,ki	आ,प,की
chu,n,vaa	चु,न,वा
sa,mbha,la,ke	स,म्भ,ल,के
aa,pa,ke	आ,प,के
aa,pa,kaa	आ,प,का
su,la,gaa,ye	सु,ल,गा,ए
su,la,gaa,ye	सु,ल,गा,ये
sa,ha,ni	स,ह,नी
aa,za,maa,ye,nge	आ,ज़,मा,यें,गे
sa,ha,na	स,ह,ना
sa,ha,ne	स,ह,ने
sa,n,saa,r	स,न,सा,र
ta,sa,bi,r	त,स,बी,र
ku,r,ti	कु,र,ती
ma,rya,daa	म,र्या,दा
fi,zaa,yon	फ़ि,ज़ा,ओं
fi,zaa	फ़ि,ज़ाँ
ka,maa	क,माँ
ka,maa,yi	क,मा,ई
ba,dho,tta,ri	ब,ढ़ो,त्त,री
ra,gi,ni,yon	रं,गी,नि,यों
jha,ka,jho,r	झ,क,झो,र
su,na,n	सु,ना,ऊँ
sa,ta,raa	स,त,रा
su,na,ye	सु,ना,ए
su,na,yi	सु,ना,ई
baa,ju,yon	बा,जु,ओं
ga,tha,ba,dha,n	ग,ठ,बं,ध,न
aa,ftaa,ba	आ,फ़्ता,ब
ba,r,baa,di,n	ब,र,बा,दि,याँ
jha,pa,ka,te	झ,प,क,ते
saa,qi,ya	सा,क़ि,या
duu,ba,taa	डू,ब,ता
a,va,sa,r	अ,व,स,र
jaa,n	जा,ऊँ
thaa,ka,re	ठा,क,रे
chaa,da,ni	चाँ,द,नी
chaa,da,ni	चां,द,नी
kyo	क्यूँ
la,gaa,yuu,gaa	ल,गा,ऊं,गा
da,ri,ya	द,रि,या
ba,dha,n	बं,ध,न
u,ga,taa	उ,ग,ता
u,ga,ti	उ,ग,ती
ku,da,r,ta	कु,द,र,ट
pa,ha,ron	प,ह,रों
jaa,n,gaa	जा,ऊँ,गा
lu,ta,taa	लु,ट,ता
jaa,n,gi	जा,ऊँ,गी
jaa,yuu,gi	जा,ऊं,गी
mu,r,li	मु,र,ली
ha,ma	ह,म
bi,ta	बी,त
gu,ma,su,ma	गु,म,सु,म
u,tte	उ,त्ते
baa,ju,yon	बा,जु,ओं
go,ri,n	गो,रि,याँ
de,kha,ne	दे,ख,ने
aa,ma,ne	आ,म,ने
aa,fa,taa,ba	आ,फ़,ता,ब
ka,r,ke	क,र,के
jha,di,n	झ,ड़ि,याँ
sa,ma,jha,taa	स,म,झ,ता
sa,gaa,yi	स,गा,ई
bhu,laa,n,gi	भु,ला,ऊँ,गी
jo,i	जो,इ
r,ha,gu,zaa,ron	र,ह,गु,ज़ा,रों
ye,ye,ye,sa,vaa,i,ye,ye,ye,n	ए,ए,ए,स,वा,इ,ए,ए,ए,न
pra,ka,r,n	प्र,क,र,ण
ma,sti,n	म,स्ति,याँ
ha,ma,ne	ह,म,ने
hi,cha,ko,le	हि,च,को,लें
pa,ha,le	प,ह,ले
pa,ha,laa	प,ह,ला
pa,he,li	प,हे,ली
pa,ni,n	प,नि,याँ
sa,ma,jhaa,na	स,म,झा,ना
chhi,da,kaa,ve	छि,ड़,का,वे
du,sha,vaa,ri,n	दु,श,वा,रि,याँ
ma,sti,n	म,स्ति,याँ
ma,sti,n	म,स्ती,याँ
ta,r,saa,na	त,र,सा,ना
zo,ha,raa	ज़ो,ह,रा
u,thaa,ne	उ,ठा,ने
ba,da,le,gi	ब,द,ले,गी
ba,da,le,gaa	ब,द,ले,गा
na,daa	ना,दाँ
to,da,ti	तो,ड़,ती
jaa	जा
to,da,taa	तो,ड़,ता
a,ga,daa,yi,yaan	अं,ग,ड़ा,ई,यां
tu,ta,ne	टू,ट,ने
raa,ja,maa,rg	रा,ज,मा,र्ग
khwaa,bon	ख्वा,बों
di,kha,laa	दि,ख,ला
bi,ga,da,ne	बि,ग,ड़,ने
su,la,jhe,gi	सु,ल,झे,गी
pa,ha,chaa,n,ti	प,ह,चा,न,ती
si,la,si,le	सि,ल,सि,ले
si,la,si,laa	सि,ल,सि,ला
ga,tha,ba,dha,n	ग,ठ,बं,ध,न
u,pa,nyaa,sa	उ,प,न्या,स
a,su,va,n	अं,सु,व,न
ka,r,taa	क,र,ता
ka,r,te	क,र,ते
ka,r,ti	क,र,ती
ma,ru	म,रूँ
mu,sha,ki,la	मु,श,कि,ल
a,ga,le	अ,ग,ले
a,ga,laa	अ,ग,ला
maa,ya,ke	मा,य,के
ma,r,ji,na	म,र,जी,ना
be,ka,raa,r	बे,क,रा,र
chhu,pa,ne	छु,प,ने
jaa,n,gi	जा,ऊँ,गी
di,shaa,ye	दि,शा,एँ
ju,aa,ri	जु,आ,री
gi,r,ftaa,r	गि,र,फ्ता,र
di,ji,ye	दी,जि,ए
a,su,yon	अं,सु,ओं
gai,r	गै,र
baa,ji,n	बा,जि,याँ
ska,da,r	स्कं,द,र
bai,tha,ka,r	बै,ठ,क,र
ba,ha,na	ब,ह,ना
ba,ha,ne	ब,ह,ने
ba,ha,ne	ब,ह,नें
ka,da,ve	क,ड़,वे
r,ha,ti	र,ह,ती
r,ha,te	र,ह,ते
r,ha,taa	र,ह,ता
ka,la,ju,ga,me	क,ल,जु,ग,में
ni,di,ya,n	निं,दि,य,न
ka,ha,laa,yi	क,ह,ला,ई
va,faa,ye	व,फ़ा,एँ
ba,taa,ye	ब,ता,एँ
mu,jha,se	मु,झ,से
bi,chhu,aa	बि,छु,आ
bhaa,r,ti,ya	भा,र,ती,य
pa,khi,n	प,खि,याँ
la,cha,kaa,i,ye	ल,च,का,इ,ये
kha,la,na,ya,ka	ख,ल,ना,य,क
sa,n,ke	स,न,के
si,khaa,yuu,gaa	सि,खा,ऊं,गा
mu,r,jhaa,ye,gaa	मु,र,झा,ये,गा
sa,gi,ta,kaa,r	सं,गी,त,का,र
ka,ja,raa,re	क,ज,रा,रे
ru,sa,vaa,i,yon	रु,स,वा,इ,यों
mu,n,nu	मु,न,नू
chha,pa,ti	छ,प,ती
vi,shva,na,th,n	वि,श्व,ना,थ,न
si,dhi,n	सी,ढि,याँ
shri,ma,ti	श्री,म,ती
ru,sa,vaa	रु,स,वा
ma,cha,la,ne	म,च,ल,ने
kha,n,ke,gi	ख,न,के,गी
chaa,ha,te	चा,ह,ते
ni,bhaa,i,yo	नि,भा,इ,यो
cha,tu,raa,yi	च,तु,रा,ई
1,7,1	1,7,1
chu,raa,ye	चु,रा,ए
ba,n,vaa,ye,nge	ब,न,वा,एँ,गे
jaa,ye	जा,ये
jaa,ye	जा,एँ
ta,da,paa,ti	त,ड़,पा,ती
ta,da,paa,tin	त,ड़,पा,तीं
hai	हैं
aa,di,vaa,si,yon	आ,दि,वा,सि,यों
va,r,na	व,र,ना
laa,yuu	ला,ऊं
me	में
di,la,ka,shi	दि,ल,क,शी
du,n,de	दू,न,दे
bo,le	बो,ले
chhu,paa,yuu	छु,पा,ऊं
ta,da,pa,taa	त,ड़,प,ता
i,tha,laa,ti	इ,ठ,ला,ती
aa,su,yon	आँ,सु,ओं
a,su,yon	आं,सु,ओं
chu,raa,yi	चु,रा,ई
chu,bha,taa	चु,भ,ता
chu,bha,ti	चु,भ,ती
pa,dhaa,yi	प,ढ़ा,ई
dha,da,ka,non	ध,ड़,क,नों
la,ha,raa,yi	ल,ह,रा,ई
tu,ma,ko	तु,म,को
	c,a,n,n,o,t, ,u,n,d,e,r,s,t,a,n,d
u,pa,yo,ga	उ,प,यो,ग
ga,la,ti,yon	ग,ल,ति,यों
aa,sa,paa,sa	आ,स, ,पा,स
pa,r,va,ta	प,र,व,त
pa,r,vaa,ha	प,र,वा,ह
chhaa,yon	छा,ओं
raa,ja,ni,ti,ka	रा,ज,नी,ति,क
baa,ji,n	बा,जि,याँ
aa,pa,na	आ,प,ना
a,pa,na	अ,प,ना
aa,pa,ne	आ,प,ने
a,pa,ne	अ,प,ने
a,pa,ni	अ,प,नी
aa,pa,ni	आ,प,नी
ta,ka,na	त,क,ना
ni,ha,ru	नि,ह,रूँ
i,ta,raa,ye	इ,त,रा,ये
ru,laa,ye	रु,ला,ए
ru,laa,o	रु,ला,ओ
phi,ru	फि,रूँ
u,ma,r	उ,म,र
a,r,ri,ya	अ,र,रि,य
sa,taa,ye,gi	स,ता,ए,गी
pa,chha,taa,o,gi	प,छ,ता,ओ,गी
ba,da,n	बं,द,न
ba,dha,n	बं,ध,न
su,n,te	सु,न,ते
su,n,ti	सु,न,ती
ba,n,vaa,n	ब,न,वा,ऊँ
mo,ha,la,ta	मो,ह,ल,त
ka,ta,raa,ke	क,त,रा,के
pra,staa,va	प्र,स्ता,व
shi,r,ka,ta	शि,र,क,त
laa,gha,ne	लाँ,घ,ने
ka,ha	क,ह
a,rmaa,non	अ,र्मा,नों
ba,na,u,gaa	ब,ना,उं,गा
si,sa,ki	सि,स,की
jhu,ma,ke	झु,म,के
jhu,ma,kaa	झु,म,का
pa,r,vaa,non	प,र,वा,नों
pa,r,vaa,ne	प,र,वा,ने
pa,r,vaa,na	प,र,वा,ना
me,ha,maa	मे,ह,माँ
ja,poo	ज,पूँ
u,dde,shya	उ,द्दे,श्य
ta,r,saa,ye	त,र,सा,ए
bi,na,i,n	बी,ना,इ,याँ
ta,r,saa,o	त,र,सा,ओ
sa,ba,ne	स,ब,ने
ve	वे
ba,r,saa,ye	ब,र,सा,ए
di,kha,laa,ke	दि,ख,ला,के
vi,r,ja,n	वि,र,ज,न
ba,r,saa,ya	ब,र,सा,या
be,chai,ni,n	बे,चै,नि,याँ
khu,shbu,yon	खु,श्बु,ओं
a,n,jaa,na	अ,न,जा,ना
n,chaa,ye	न,चा,एँ
u,lle,kha,ni,ya	उ,ल्ले,ख,नी,य
ni,chha,da,taa	नि,छ,ड़,ता
ba,yi,ya	ब,ई,या
n,za,ron	न,ज़,रों
n,za,re	न,ज़,रे
aa,ye,gi	आ,ए,गी
aa,ye,gaa	आ,ए,गा
mu,aa	मु,आ
i,sa,ko	इ,स,को
ni,bhaa,ye,nge	नि,भा,एं,गे
ni,bhaa,ye,nge	नि,भा,यें,गे
pa,ha,la,vaa,n	प,ह,ल,वा,न
gha,ba,raa,te	घ,ब,रा,ते
u,n,me	उ,न,में
jaa,ye,gi	जा,ए,गी
jaa,ye,gaa	जा,ए,गा
la,da,ti	ल,ड़,ती
ha,ri,ya,laa	ह,रि,या,ला
la,da,te	ल,ड़,ते
baa	बाँ,धूँ
khe,ti,n	खे,ति,याँ
ka,rma	क,र्म
ha,ta,na	ह,ट,ना
r,ha,te	र,ह,ते
a,ga,daa,yi	अं,ग,ड़ा,ई
dhya,n,cha,da	ध्या,न,चं,द
va,no,i	व,नो,इ
saa,re	सा,रे
u,pa,ka,r,n	उ,प,क,र,ण
si,vaa	सि,वा
vya,ku,la	व्या,कु,ल
do	दो, ,n,u,m
aa,sa,paa,sa	आ,स,पा,स
aa,sa,paa,sa	आ,स, ,पा,स
ta,da,paa,ne,vaa,li	त,ड़,पा,ने,वा,लि
aa,khe	आँ,खें
ba,dhaa,i,ye	ब,ढ़ा,इ,ये
se,ha,raa	से,ह,रा
sa,ha,raa	स,ह,रा
du,jaa	दू,जा
a,bu	अ,बु
ba,ha,laa,o	ब,ह,ला,ओ
su,na,ye	सु,ना,एँ
jha,n,kaa,ren	झ,न,का,रें
kyo	क्यूँ
ja,n,va,ri	ज,न,व,री
ho,ki	हॉ,की
gho,sha,na	घो,ष,णा
da,vaa,yi	द,वा,ई
pa,ka,da,te	प,क,ड़,ते
paa,ga,lon	पा,ग,लों
u,n,pe	उ,न,पे
po,ta,li	पो,ट,ली
bu,re	बु,रे
ba,dho,tta,ri	ब,ढ़ो,त्त,री
mo,da,ke	मो,ड़,के
cha,ma,ka,taa	च,म,क,ता
gi,r,te	गि,र,ते
gha,ba,raa,ye	घ,ब,रा,ये
pa,ri,yo,ja,na,ye	प,रि,यो,ज,ना,एं
gi,r,taa	गि,र,ता
gi,r,ti	गि,र,ती
bu,laa,ye	बु,ला,एँ
ti,n,kon	ति,न,कों
ti,n,ke	ति,न,के
ti,n,kaa	ति,न,का
ba,r,sa,ne	ब,र,स,ने
mu,r,daa	मु,र,दा
ja,ga,ma,gaa,ye	ज,ग,म,गा,ए
sa,haa,ya,taa	स,हा,य,ता
ma,na,o	म,ना,ओ
sa,baa	स,बाँ
vaa,pa,si	वा,प,सी
ka,rma,chaa,ri,yon	क,र्म,चा,रि,यों
da,ha,li,jon	द,ह,ली,जों
go,saa,vi,na,da,n	गो,सा,वी,नं,द,न
gu,n,gu,na,ti	गु,न,गु,ना,ती
kaa,mo,o,sha	ख़ा,मो,ओ,श
da,sa,n	द,स,ताँ
ki,r,daa,r	कि,र,दा,र
ha,ma,ko	ह,म,को
ma,r,ne	म,र,ने
ma,r,na	म,र,ना
ha,ma,kaa	ह,म,का
daa,va,n	वृं,दा,व,न
aa,yi	आ,ई
du,ri,n	दू,रि,याँ
pyaa,laa	प्या,ला
ma,ja,boo,ri,n	म,ज,बू,रि,याँ
pa,da,te	प,ड़,ते
chha,la,kaa,taa	छ,ल,का,ता
ha,vaa,ye	ह,वा,एँ
n,haa,ye	न,हा,एँ
chhu,ta,kaa,raa	छु,ट,का,रा
chi,nma,ya	चि,न्म,य
be,ti,n	बे,टि,याँ
sa,ka,taa	स,क,ता
mi,ta,ka,r	मि,ट,क,र
ji,ta,ne	जी,त,ने
di,khaa,ye	दि,खा,एं
5,5	5,4,5
khaa,ye	खा,एं
baa,va,ju,da	बा,व,जू,द
chu,n,na	चु,न,ना
ba,ha,laa,ti	ब,ह,ला,ती
du,sa,re	दू,स,रे
du,sa,raa	दू,स,रा
du,sa,ri	दू,स,री
bhaa,jaa,paa,yi	भा,जा,पा,ई
sa,r,kaa,yi	स,र,का,ई
sa,r,kaa,o	स,र,का,ओ
pa,ri,n	प,रि,याँ
pa,ri,n	प,री,याँ
maa,noo	मा,नूँ
gu,za,r,ti	गु,ज़,र,ती
ha,vaa,ye	ह,वा,एं
ni,bhaa,n,gi	नि,भा,ऊँ,गी
pa,la,sa,faa	प,ल,स,फा
mi,ta,ke	मि,ट,के
di,n,ka,r	दि,न,क,र
ba,dha,vaa,le	बँ,ध,वा,ले
jaa,na	जा,नाँ
pa,rda	प,र्दा
vi,maa,n,ta,la	वि,मा,न,त,ल
aa,sa,maa,n	आ,स,मा,न
aa,sa,maa	आ,स,मां
aa	आ,स्माँ
ba,ha	ब,ह
a,dhi,ka	अ,धि,क
aa,khe	आँ,खें
poo	पू,जूँ
ka,taa,yon	ख़,ता,ओं
pa,da,taa	प,ड़,ता
pa,da,ti	प,ड़,ती
chi,llaa,yi	चि,ल्ला,ई
choo	चूँ
ghoo,ma,te	घू,म,ते
ya,haa	य,हाँ
raa	रा
raa,ha,ta	रा,ह,त
poo,chhuu	पू,छूँ
pa,r,vaa,ne	प,र,वा,ने
pa,r,vaa,na	प,र,वा,ना
baa,da,lon	बा,द,लों
se,na,ye	से,ना,एँ
de,kha,ka,r	दे,ख,क,र
ru,sa,vaa,i,n	रु,स,वा,इ,योँ
hi,la,ti	हि,ल,ती
hi,la,taa	हि,ल,ता
i	इ,म्काँ
n,ga,ri	न,ग,री
su,na,n	सु,ना,ऊँ
ma,r,ta,baa,non	म,र,त,बा,नों
se,ye	से,ए
gha,ta,na	घ,ट,ना
u,sa,ko	उ,स,को
u,sa,ke	उ,स,के
ma,ja,bo,o,r	म,ज,बो,ओ,र
u,maa,daa,n,gu,maa,daa,n	उ,मा,दा,न, ,गु,मा,दा,न
ha,sa,na	हँ,स,ना
ta,la,vaa,ron	त,ल,वा,रों
r,ho,n,gi	र,हो,ओँ,गी
su,r,maa	सु,र,मा
su,r,me	सु,र,मे
ma,ha,ka,taa	म,ह,क,ता
ma,ha,ka,ti	म,ह,क,ती
lu,gaa,yi	लु,गा,ई
phe,ka,taa	फें,क,ता
ta,da,pa,n	त,ड़,प,न
maa,la,ki,ta	मा,ल,की,ट
ta,da,paa	त,ड़,पा
sa,daa,yon	स,दा,ओं
jaa,i,ye	जा,इ,ये
a,pa,na,ye	अ,प,ना,एँ
a,pa,na,ya	अ,प,ना,या
ma,hu,aa	म,हु,आ
ju,da,ne	जु,ड़,ने
baa,va,ri	बा,व,री
baa,va,ri	बा,व,री
pa,chha,taa,yuu,gaa	प,छ,ता,ऊं,गा
hu,ye	हु,ए
hu,yi	हु,ई
dhaa,yi	ढा,ई
sa,ta,ra,gi	स,त,रं,गी
cha,la,ti	च,ल,ती
gu,la,si,taan	गु,ल,सि,तां
ba,taa,li,ya,n	ब,टा,लि,य,न
chu,n,vaa,ye,gi	चु,न,वा,ए,गी
	c,a,n,n,o,t, ,u,n,d,e,r,s,t,a,n,d
n	वाँ
mi,la,na	मि,ल,ना
mi,la,n	मि,ल,न
ji,ta,ne	जी,त,ने
mi,la,ne	मि,ल,ने
mi,la,ne	मि,ल,नें
ma,ya,ka,de	म,य,क,दे
u,tha,ti	उ,ठ,ती
pa,laa,ni,ma,kka,ma	प,ला,नि,म,क्क,म
u,tha,taa	उ,ठ,ता
ba,jaa,yuu,gaa	ब,जा,ऊं,गा
sa,r,son	स,र,सों
gu,ma,shu,daa	गु,म,शु,दा
n,ka,li	न,क,ली
so,cha,ka,r	सो,च,क,र
u,da,taa	उ,ड़,ता
tu,ma,saa	तु,म,सा
bhaa,sha,non	भा,ष,णों
bi,r,laa	बि,र,ला
ji,sa,ma	जि,स,म
tu,la,si	तु,ल,सी
ki,r,non	कि,र,नों
ki,r,non	कि,र,णों
i,kaa,i,yon	इ,का,इ,यों
vi,daa,yi	वि,दा,ई
so,cha,taa	सो,च,ता
ni,kha,raa	नि,ख,रा
chaa,hoo	चा,हूँ
da,r,vaa,je	द,र,वा,जे
vya,va,stha,yon	व्य,व,स्था,ओं
le	ले
su,n,lo	सु,न,लो
haa,re	हा,रे
khya,la	ख्या,ल
kyaa,la	ख़्या,ल
sa,haa,r,n,pu,r	स,हा,र,न,पु,र
tu,mhen	तु,म्हें
cha,raa	च,रा,ग़ाँ
ga,ha,raa,yi	ग,ह,रा,ई
ka,ma,zo,ri	क,म,ज़ो,री
pa,r,de,si,ya	प,र,दे,सि,या
ka,ha,ne,pe	क,ह,ने,पे
pa,ha,chaa,na	प,ह,चा,ना
va,faa	व,फ़ा
vaa,faa,o	वा,फा,ओ
a,ga,daa,yi	अँ,ग,ड़ा,ई
a,ga,daa,yi	अं,ग,ड़ा,ई
jaa,ye,gi	जा,एं,गी
ka,ya,la	ख़,या,ल
i,sa,se	इ,स,से
raa,ja,ma,tri	रा,ज,मं,त्री
u,daa,r,ni,ti	उ,दा,र,नी,ति
ma,chaa,yi	म,चा,ई
ba,na,o	ब,ना,ओ
ba,na,yi	ब,ना,ई
a,sta,raa	अ,स्त,राँ
kaa,rya,ka,rta	का,र्य,क,र्ता
pa,ha,laa	प,ह,ला
n,ga,me	न,ग़,मे
n,ga,maa	न,ग,मा
n,ga,maa	न,ग़,मा
yuu	यूँ
mu,sku,raa	मु,स्कु,रा
la,gi,n	ल,गि,याँ
pa,chha,taa,ye	प,छ,ता,ए
pa,chha,taa,ye	प,छ,ता,ये
laa,ye,gaa	ला,ए,गा
na,kaa,mi	ना,का,मी
kho,luu	खो,लूँ
ru,pa,ha,laa	रु,प,ह,ला
sha,ta,ra,ja	श,त,रं,ज
mu,yi	मु,ई
ru,ta,baa	रु,त,बा
kha,r,boo,je	ख,र,बू,जे
kha,r,boo,jaa	ख,र,बू,जा
n,r,mi,yaan	न,र,मि,यां
ye,sa,ye,aa,i,ye,la	ए,स, ,ए, ,आ,इ, ,ए,ल
pa,dha,vaa,ya	प,ढ़,वा,या
ba,ndhu,yon	ब,न्धु,ओं
ji,se	जि,से
i,sa,sa,ke	इ,स,स,के
taa,re	ता,रे
sa,r,go,shi,yo	स,र,गो,शि,यो
aa,o,gi	आ,ओ,गी
ga,la,ti,yon	ग,ल,ति,यों
hai,raa	है,राँ
tu,mhaa,ri	तु,म्हा,री
sa,n,sa,na,ha,ta	स,न,स,ना,ह,ट
tu,mhaa,re	तु,म्हा,रे
aa,ye,gi	आ,ए,गी
aa,ye,gaa	आ,ए,गा
5,7,sau	5,7,0
sa,ba,ko	स,ब,को
pa,ri,sthi,yon	प,रि,स्थि,यों
duu,ba,na	डू,ब,ना
di,vaa,n,gi	दी,वा,न,गी
sa,la,maa	स,ल,मा
mu,jha,ko	मु,झ,को
ha,ma,saa	ह,म,सा
ha,ma,se	ह,म,से
i,ta,na	इ,त,ना
vaa,li,n	वा,लि,याँ
u,la,jhaa,ya	उ,ल,झा,या
ku,ma,ku,ma	कु,म,कु,म
sa,ma,jhaa,yuu	स,म,झा,ऊं
saa,i,n	सा,इ,याँ
gha,ta,na	घ,ट,ना
ka,vaa,bo,kha,ya,lo	क,वा,बो,ख,या,लो
ha,r,taa	ह,र,ता
bo,luu	बो,लूँ
ha,la,cha,le	ह,ल,च,लें
kon,ka,n	कों,क,ण
ja,ga,vaa,le	ज,ग,वा,ले
bu,jhaa,o	बु,झा,ओ
vaa,de	वा,दे
sa,da,kon	स,ड़,कों
tu,jhe	तु,झे
khaa,n,paa,n	खा,न,पा,न
ta,n,haa,yi	त,न,हा,ई
ha,la,cha,la	ह,ल,च,ल
a,lbe,le	अ,ल्बे,ले
pa,chha,taa,o,nge	प,छ,ता,ओ,गे
a,pa,n	अ,प,न
a,pa,na	अ,प,ना
ma,ja,boo,r	म,ज,बू,र
a,pa,ne	अ,प,ने
a,pa,ni	अ,प,नी
a,pa,ne	अ,प,ने
a,pa,ni	अ,प,णी
a,pa,ni	अ,प,नी
aa,pa,ni	आ,प,नी
a,pa,non	अ,प,नों
aa,jaa,o	आ,जा,ओ
kha,ri,da	ख,री,द
ba,dho,tta,ri	ब,ढ़ो,त्त,री
pa,ha,li	प,ह,ली
ghoo,ma,ti	घू,म,ती
la,goo	ल,गूँ
bi,ja,li	बि,ज,ली
a,ta,kaa	अ,ट,का
chho,da,ke	छो,ड़,के
jaa,ye,n,nge	जा,ये,न,गे
u,ta,ni	उ,त,नी
u,ta,na	उ,त,ना
u,tha,ne	उ,ठ,ने
u,ta,ne	उ,त,ने
mu,jha,ko	मु,झ,को
ga,ha,re	ग,ह,रे
ta,da,poo	त,ड़,पूँ
ga,ha,ri	ग,ह,री
su,n,ka,r	सु,न,क,र
raa,ja,ne,taa,yon	रा,ज,ने,ता,ओं
phi,r,na	फि,र,ना
maa,i,ke,la	मा,इ,के,ल
ba,ha,laa,o,nge	ब,ह,ला,ओ,गे
u,sa,pe	उ,स,पे
ja,la,vaa	ज,ल,वा
la,gaa,ne	ल,गा,ने
ma,ha,jaa,bi,n	म,ह,जा,बी,न
laa,gha,ne	लाँ,घ,ने
da,r,na	ड,र,ना
ka,ma,zo,r	क,म,ज़ो,र
sa,ve,da,n,shi,la	सं,वे,द,न,शी,ल
ja,maa	ज,मा
la,ha,raa,te	ल,ह,रा,ते
ja,laa,ye	ज,ला,एँ
ba,ta,laa,na	ब,त,ला,ना
khuu,ba,suu,r,ta	खू,ब,सू,र,त
koo,ba,suu,r,ta	ख़ू,ब,सू,र,त
jaa,n,kaa,ri	जा,न,का,री
ka,raan,nge	क,रां,गे
su,laa,n,gi	सु,ला,ऊँ,गी
jhuu,ma,ne	झू,म,ने
ma,sha,hu,r	म,श,हू,र
ba,da,la	ब,द,ल
kaa,r,n	का,र,वाँ
ka,r,va,ta	क,र,व,ट
fra,si,si	फ्रां,सी,सी
ha,ma,n,vaa	ह,म,न,वा
ta,r,saa,na	त,र,सा,ना
ba,ha,ko,nge	ब,ह,को,गे
ha,sa,ton	हँ,स,तों
baa,la,maa	बा,ल,मा
the	थे
dha,r,na	ध,र,ना
chi,la,ma,n	चि,ल,म,न
ba,la,vaa,n	ब,ल,वा,न
di,vaa,n,gi	दी,वा,न,गी
di,va,n,gi	दी,व,न,गी
laa,chaa,ri,n	ला,चा,रि,याँ
praa,th,mi,ka,taa	प्रा,थ,मि,क,ता
ka,raa,yuu,gaa	क,रा,ऊं,गा
na,daa	ना,दाँ
saa,ku	सा,कु
sa,koo	स,कूँ
pra,dhaa,n,ma,tri	प्र,धा,न,मं,त्री
ka,mpa,ni,n	क,म्प,नि,याँ
khuu,ba,suu,r,ta	खू,ब,सू,र,त
ma,n,vaa	म,न,वा
sa,ga,di,la	सं,ग,दि,ल
ka,r,di	क,र,दी
dha,da,kaa,ti	ध,ड़,का,ती
mu,jha,pe	मु,झ,पे
bi,ta,te	बी,त,ते
ka,ga,n	कं,ग,न
sa,ma,jhaa,n	स,म,झा,ऊँ
bho,ja,shaa,laa	भो,ज,शा,ला
u,ta,re,gi	उ,त,रे,गी
u,ta,re,gaa	उ,त,रे,गा
ja,ga,maa,yi	ज,ग,मा,ई
jaa,n,gi	जा,ऊँ,गी
jaa,yuu,gi	जा,ऊं,गी
jaa,yuu,gaa	जा,ऊं,गा
jaa,n,gaa	जा,ऊँ,गा
ji,yuu	जि,यूँ
mi,la,te	मि,ल,ते
u,thaa,ye	उ,ठा,ए
sa,ma,jhaa,ya	स,म,झा,य
da,la	ड,ल
ru,sa,vaa,yi	रु,स,वा,ई
chi,ta,cho,r	चि,त,चो,र
pa,la,kon	प,ल,कों
i,ta,raa,ye	इ,त,रा,एं
ko,yi	को,ई
ra,gaa,n,gi	रँ,गा,ऊँ,गी
khi,le,nge	खि,लें,गे
ti,ka,na	ति,क,ना
ha,r,gi,za	ह,र,गि,ज़
baa,va,raa	बा,व,रा
1,7,3	1,9,7,3
1,7,1	1,9,7,1
jha,ta,ke	झ,ट,के
i,n,me	इ,न,में
na,cha,te	ना,च,ते
na,cha,ti	ना,च,ती
n,za,di,ka	न,ज़,दी,क
aa,sa,maa,n	आ,स,मा,न
aa,sa,maa	आ,स,मां
a,rz	अ,र्ज़
ka,ha,ti	क,ह,ती
ja,la,ne	ज,ल,ने
a,pa,raa,ndhi	अ,प,रा,धी
a,shaa,yon	अ,शा,ओं
ku,di,n	कु,ड़ि,याँ
bha,ren,nge	भ,रें,गे
a,lha,da,pa,n	अ,ल्ह,ड़,प,न
sa,ma,jha,ti	स,म,झ,ती
ka,cha,n	कं,च,न
ji,la,mi,la,taa	जि,ल,मि,ल,ता
a,n,de,khi	अ,न,दे,खी
ba,raa,n	ब,रा,ताँ
r,ja,ni,ga,dhaa	र,ज,नी,गं,धा
tai,ya,ri,n	तै,या,रि,याँ
saa,va,ri,ya	साँ,व,रि,या
ju,baa,ya,daa	जु,बा,य,दा
ba,taa,li,ya,n	ब,टा,लि,य,न
su,n,saa,n	सु,न,सा,न
ni,haa	नि,हाँ
ka,ja,raa	क,ज,रा
ka,ja,re	क,ज,रे
ka,ja,ri	क,ज,री
di,khaa,ye	दि,खा,एँ
ke	के
r,hoo	र,हूँ
su,r,ji,ta	सु,र,जी,त
pa,ha,re,daa,r	प,ह,रे,दा,र
poo,chhuu	पू,छूँ
sa,ha,raa	स,ह,रा
bi,chha,da,na	बि,छ,ड़,ना
ja,n,vaa,n	ज,न,वा,न
jaa,n,va,r	जा,न,व,र
li,pa,te	लि,प,टे
li,pa,taa	लि,प,टा
li,pa,ti	लि,प,ती
li,pa,ti	लि,प,टी
pa,r,de,sa	प,र,दे,स
ku,daa,yon	ख़ु,दा,ओं
so,cha,ti	सो,च,ती
so,cha,te	सो,च,ते
ta,koo	त,कूँ
ka,hoo	क,हूँ
maa,go	माँ,गो
u,pa,vi,je,ya,taa	उ,प,वि,जे,य,ता
va,ta,n,pa,r,ston	व,त,न,प,र,स्तों
a,ga,daa,yi	अँ,ग,ड़ा,ई
a,ng,daa,yi	अ,न्ग,ड़ा,ई
a,ga,daa,yi	अं,ग,ड़ा,ई
a,n,ga,daa,yi	अ,न,ग,डा,ई
haa,la,hi	हा,ल,ही
mu,r,jhaa,ye	मु,र,झा,ए
mu,r,jhaa,yi	मु,र,झा,यी
mu,r,jhaa,yi	मु,र,झा,ई
bhaa,jaa,paa,yi	भा,जा,पा,ई
ye,ka,ju,ta	ए,क,जु,ट
r,ta,laa,ma	र,त,ला,म
pyaa,r	प्या,र
ju,ni,ya,r	जू,नि,य,र
gha,n,va	घा,न,व
la,ha,raa,i,ye	ल,ह,रा,इ,ये
si,yuu	सि,यूँ
da,r,ba,daa,r	ड,र,ब,दा,र
ba,cha,ne	ब,च,ने
ba,cha,na	ब,च,ना
sa,da,ke	स,ड़,के
sa,da,ke	स,द,के
vaa,di,n	वा,दि,याँ
sa,ma,jho,gi	स,म,झो,गी
ju,noo	जु,नूँ
u,la,jha,non	उ,ल,झ,नों
u,thaa,ye	उ,ठा,एं
bhaa,ga,ne	भा,ग,ने
ta,sa,vi,r	त,स,वी,र
lo,ka,ni,rmaa,n	लो,क,नि,र्मा,ण
kha,n,kaa,yi	ख,न,का,ई
ma,cha,ti	म,च,ती
ta,r,se,gi	त,र,सें,गी
i,sa,ko	इ,स,को
i,sa,ki	इ,स,की
i,sa,ke	इ,स,के
i,sa,kaa	इ,स,का
ta,r,se,nge	त,र,सें,गे
u,pa,la,yon	उ,प,ल,ब्धि,यों
ma,ha,ja,bin	म,ह,ज,बीं
a,ha,ma,da	अ,ह,म,द
u,pa,haa,r	उ,प,हा,र
de,khuu	दे,खूँ
la,ha,raa,yi	ल,ह,रा,ई
maa	माँ
du,haa,yi	दु,हा,ई
maa,yu,si,n	मा,यू,सि,याँ
mu,jhe	मु,झे
mi,khaa,i,la	मि,खा,इ,ल
pa,ha,lu	प,ह,लू
pa,taa	प,ता
3,do	4, ,3,2,9
ni,bhaa,o,gi	नि,भा,ओ,गी
dho,o,ye	धो,ओ,ये
phu,la,vaa,ri,ya	फु,ल,वा,रि,या
baa,dha,ti	बाँ,ध,ती
da,r,ne	ड,र,ने
da,r,na	ड,र,ना
ra,ga,vaa,yi	रं,ग,वा,ई
phi,ru	फि,रूँ
r,n,ji	र,ण,जी
bhaa,ja,paa	भा,ज,पा
chho,doo	छो,ड़ूँ
aa,sa,maa	आ,स,माँ
aa,sa,maa,n	आ,स,मा,न
aa,sa,maa,n	आ,स,मा,न
aa	आ,स्माँ
aa,sa,maa	आ,स,मां
paa,ye,gi	पा,ए,गी
sa,r,fa,ro,shi	स,र,फ़,रो,शी
r,sa,te	र,स,ते
r,khuu	र,खूँ
bhaa,va,ri,ya	भाँ,व,रि,या
hi	हि,ज्राँ
ma,ha,ru,ma	म,ह,रू,म
ba,ha,ka,na	ब,ह,क,ना
ba,ha,ka,ne	ब,ह,क,ने
vaa,ni,n	वा,नि,याँ
ba,rbaa,di	ब,र्बा,दी
ba,da,na,mi,yon	ब,द,ना,मि,यों
ko,ye	को,ए
r,ta,laa,ma	र,त,ला,म
mo,ti,n	मो,ति,याँ
sa,ha,mi	स,ह,मी
tai,yya,ri,n	तै,य्या,रि,याँ
hu,ma,ko	हु,म,को
ha,ma,ko	ह,म,को
ha,ma	ह,म,कॊ
ha,ma,kaa	ह,म,का
ba,n,ka,r	ब,न,क,र
laa,n	ला,ऊँ
u,mmi,da,vaa,r	उ,म्मी,द,वा,र
tu,jha,me	तु,झ,मे
tu,jha,me	तु,झ,में
sa,maa	स,मा
sa,maa	स,मा
sa,maa	स,मा
baa,ji,n	बा,जि,याँ
sha,ha,na,yi,ya	श,ह,ना,ई,या
la,da,ki	ल,ड़,की
la,da,kon	ल,ड़,कों
la,da,kaa	ल,ड़,का
la,da,ke	ल,ड़,के
paa,i	पा,इ
paa,yi	पा,ई
paa,yi	पा,यी
ja,haa	ज,हाँ
ba,r,saa,va,ta	ब,र,सा,व,त
r,yi,sa	र,ई,स
dha,da,kaa,ne	ध,ड़,का,ने
pra,ti,maa,yon	प्र,ति,मा,ओं
chha,la,te	छ,ल,ते
khi,zaa,yon	खि,ज़ा,ओं
chha,la,ti	छ,ल,ती
ga,hoo	ग,हूँ
pa,ta,sa,n	प,ट,स,न
raa,ja,swa	रा,ज,स्व
la,ha,raa,yi	ल,ह,रा,ई
ji,n,ke	जि,न,के
nau,ka,r,shaa,ho	नौ,क,र,शा,हों
ghu,ta,taa	घु,ट,ता
ta,da,paa,ye,gi	त,ड़,पा,एं,गी
a,r,maa	अ,र,माँ
kaa,r,vaan	का,र,वां
ja,gaa,yi	ज,गा,ई
ba,laa,ye	ब,ला,एँ
ja,taa,o	ज,ता,ओ
ne	ने
taa,pa,maa,n	ता,प,मा,न
a,pa,ni	अ,प,नी
pu,ye	पु,ए
sai,n	सै,याँ
vaa,ru	वा,रूँ
be,taa,bi,n	बे,ता,बि,याँ
bu,n,taa	बु,न,ता
ha,ma,raa,hi	ह,म,रा,ही
bu,n,ti	बु,न,ती
u,taa,r,taa	उ,ता,र,ता
u,ta,r,taa	उ,त,र,ता
aa,su,yon	आँ,सु,ओं
ma,ga,taa	मं,ग,ता
ha,r,jaa,yi	ह,र,जा,ई
kaa,r,n	का,र,ण
ka,r,ma	क,र,म
ha,si	हँ,सी
tu,jha,pe	तु,झ,पे
ra,gi,n	रं,गी,न
ba,da,li	ब,द,ली
bi,kha,raa	बि,ख,रा
ja,n,jaa,ti	ज,न,जा,ति
ba,dho,tta,ri	ब,ढ़ो,त्त,री
ho,te	हो,ते
	c,a,n,n,o,t, ,u,n,d,e,r,s,t,a,n,d
sa,he,li,n	स,हे,लि,याँ
ka,thi,na,yi	क,ठि,ना,ई
aa,o,nge	आ,ओ,गे
sa,ta,ra,gi	स,त,रं,गी
bu,laa,o,nge	बु,ला,ओ,गे
no,o,ri	नो,ओ,री
la,r,ja,te	ल,र,ज,ते
u,ri,n	उ,रि,याँ
mu,sku,raa,ye	मु,स्कु,रा,येँ
swa,pa,n	स्व,प,न
sa,da,bu,ddh	स,द,बु,द्ध
ka,r,lo	क,र,लो
ka,r,le	क,र,ले
laa,da,le	ला,ड,ले
di,kha,ti	दि,ख,ती
di,ka	दि,क,ह्ते
di,kha,te	दि,ख,ते
	तूँ
saa	सा
u,tha,taa	उ,ठ,ता
gu,n,gu,na,o,nge	गु,न,गु,ना,ओ,गे
bha,raa,o	भ,रा,ओ
mu,da,kaa	मु,द,का
mu,da,ke	मु,ड़,के
si,ga,n,la	सि,ग,न,ल
sa,r,kaa,na	स,र,का,ना
bhaa,jaa,paa,yi	भा,जा,पा,ई
chhu,daa,o	छु,ड़ा,ओ
i,tha,laa,na	इ,ठ,ला,ना
sa,ve,re	स,वे,रे
du,kha,te	दु,ख,ते
ma,cha,la,ke	म,च,ल,के
n,di,n	न,दि,याँ
n,di,ya	न,दि,या
ki,zaa	ख़ि,ज़ाँ
du,sha,ma,n	दु,श,म,न
ja,n	ज,वाँ
nau,ja,n	नौ,ज,वाँ
	c,a,n,n,o,t, ,u,n,d,e,r,s,t,a,n,d
ye,va	ए,वं
sa,mbhaa,la,na	स,म्भा,ल,ना
chi,ta,ra,ja,n	चि,त,रं,ज,न
baa,va,ri	बा,व,री
ma,n,suu,ba	म,न,सू,ब
ki,ta,te	कि,त,ते
ka,ma,si,n	क,म,सि,न
ka,la,gi	क,ल,गी
pa,re,shaa	प,रे,शाँ
pa,ha,na,ya	प,ह,ना,या
ku,da,maa,yi	कु,ड़,मा,यी
n,hin	न,हीं
ma,ha,maa	म,ह,माँ
chu,raa,n,gaa	चु,रा,ऊँ,गा
n,haa,yi	न,हा,ई
1,do,7	1,2,4,7
gi,raa,ye	गि,रा,ए
su,r,ksha	सु,र,क्षा
la,da,ki,yaan	ल,ड़,कि,यां
ta,da,pi	त,ड़,पी
ta,da,pe	त,ड़,पे
ta,da,paa	त,ड़,पा
mu,da,ti	मु,ड़,ती
r,jaa,yi	र,जा,ई
la,daa,i,yon	ल,ड़ा,इ,यों
a,dha,kaa,r	अं,ध,का,र
ba,dhaa,ye	ब,ढ़ा,ये
jaa,n,ka,r	जा,न,क,र
paa,va	पाँ,व
chhu,yi	छु,ई
chu,yi	चु,ई
paa,ye	पा,ए
chu,aa	चु,आ
chhu,aa	छु,आ
paa,va	पाँ,व
paa,o	पा,ओ
paa,yon	पा,ओं
paa	पा
so,ma,vaa,r	सो,म,वा,र
hoo	हूँ
ji,ne	जी,ने
ta,r,saa,ye,gi	त,र,सा,एं,गी
di,la,daa,ron	दि,ल,दा,रों
bhaa,jaa,paa,yi	भा,जा,पा,ई
cha,ma,kaa,yuu	च,म,का,ऊं
laa,o	ला,ओ
lu,taa,n,gaa	लु,टा,ऊँ,गा
u,daa,yuu,gaa	उ,ड़ा,ऊं,गा
lu,taa,yuu,gi	लु,टा,ऊं,गी
ba,da,le,nge	ब,द,लें,गे
pa,chha,taa,ye	प,छ,ता,ए
pyaa,r	प्या,र
ta,n,haa,yi	त,न,हा,ई
aa,i,ne	आ,इ,ने
aa,yi,ne	आ,ई,ने
aa,yi,na	आ,ई,ना
aa,i,na	आ,इ,ना
ghoo,ma,ne	घू,म,ने
ba,jaa,yi	ब,जा,ई
ba,jaa,o	ब,जा,ओ
sa,ha,ron	स,ह,रों
ba,jaa,ye	ब,जा,ये
ba,jaa,ye	ब,जा,ए
ma,ha,ki	म,ह,की
cha,ha,cha,haa,na	च,ह,च,हा,ना
be,va,ta,non	बे,व,त,नों
ta,r,saa,ye	त,र,सा,ए
dau,da,ti	दौ,ड़,ती
jhu,laa,ye,gi	झु,ला,एँ,गी
bhaa,ga,ti	भा,ग,ती
lu,yi	लु,ई
bi,ja,li,n	बि,ज,लि,याँ
bi,ja,li,n	बि,ज,ली,याँ
ma,da,ho,shi,yaan	म,द,हो,शि,यां
ta,ka,raa,ve	ट,क,रा,वे
gu,ru,bhaa,yi	गु,रु,भा,ई
la,r,zaa	ल,र,ज़ाँ
aa,za,maa,ye	आ,ज़,मा,ये
ye,ha,saa,sa	ए,ह,सा,स
ya,ko,yi	या,को,ई
sa,haa,ya,taa	स,हा,य,ता
3,3,1,1	3,3, ,1,1
bi,kha,raa,ye,nge	बि,ख,रा,एं,गे
ba,r,saa,o	ब,र,सा,ओ
ba,r,saa,la	ब,र,सा,ल
ba,r,saa,ta	ब,र,सा,त
ma,staa,ni	म,स्ता,नी
n,chaa,yi	ऊँ,चा,ई
so,ni,ya	सो,नि,या
hi,ga,li,sha	हिं,ग,लि,श
mu,khya,ma,tri	मु,ख्य,मं,त्री
a,ga,daa,i,n	अं,ग,ड़ा,इ,याँ
a,ga,daa,i,yaan	अं,ग,ड़ा,इ,यां
u,la,fa,ta	उ,ल,फ़,त
raa,yi	रा,ई
du,aa,yon	दु,आ,ओं
a,gaa,re	अं,गा,रे
me,ha,maa	मे,ह,माँ
aa,pa,ko	आ,प,को
si,kha,laa,ye	सि,ख,ला,ए
mu,jha,me	मु,झ,मे
mu,jha,me	मु,झ,में
ta,r,ha	त,र,ह
ta,r,haa	त,र,हा
du,aa,ye	दु,आ,एँ
du,aa,ye	दु,आ,एं
ta,ka,taa	त,क,ता
r,chaa,n	र,चा,ऊँ
ru,sa,vaa,yi	रु,स,वा,ई
no,ti	नो,टी,स्ड
pyaa,li,n	प्या,लि,याँ
lau,taa,ye	लौ,टा,ए
ho	:,हो,:
mi,ta,te,nge	मि,ट,टें,गे
bhaa,ja,paa	भा,ज,पा
saa,ja,na	सा,ज,ना
ba,taa,i,yo	ब,ता,इ,यो
ba,taa,i,ye	ब,ता,इ,ये
laa,kha	ला,ख, ,n,u,m
ju,sa,taa,ju	जू,स,ता,जू
i,kaa,i,yon	इ,का,इ,यों
sa,hoo	स,हूँ
ti,sa,ri	ती,स,री
ba,n,vaa,yi	ब,न,वा,ई
bi,la,kha,taa	बि,ल,ख,ता
dha,n,vaa,n	ध,न,वा,न
mu,da,ri	मुं,द,री
baa,li,n	बा,लि,याँ
ne	ने
r,ha,ne,vaa,li	र,ह,ने,वा,ली
sa,ha,na,yi	स,ह,ना,ई
aa,zaa,di,n	आ,ज़ा,दि,याँ
thu,ka,raa,ya	ठु,क,रा,या
a,va,sa,ron	अ,व,स,रों
raa,jha,na	राँ,झ,ना
kaa,la,ja,yi	का,ल,ज,यी
gu,n,gu,na,ye	गु,न,गु,ना,ए
lo,ka,sa,bhaa	लो,क,स,भा
li,pa,taa,ye	लि,प,टा,ए
sa,ba,se	स,ब,से
tu,mhe,ye	तु,म्हे,एं
pa,she,maa,ni,n	प,शे,मा,नी,याँ
r,sa,me	र,स,में
nu,maa,i,sha	नु,मा,इ,श
ba,n,ti	ब,न,ती
ba,n,taa	ब,न,ता
ba,n,te	ब,न,ते
ju,ga,noo	जु,ग,नूँ
chi,nma,ya	चि,न्म,य
ta,vaa,ya,fein	त,वा,य,फ़ें
la,gaa,luu	ल,गा,लूँ
u,jaa,le	उ,जा,ले
aa,i,ye,sa,ye,sa	आ,इ,ए,स,ए,स
ba,dha,te	ब,ढ़,ते
se	से
me,ha,maa,non	मे,ह,मा,नों
hoo	हूँ
gu,za,r,te	गु,ज़,र,ते
gu,ja,r,te	गु,ज,र,ते
gu,za,r,taa	गु,ज़,र,ता
jaa,ni,n	जा,नि,याँ
va,ri,ya,taa	व,री,य,ता
paa,yuu	पा,ऊं
ka,ma,laa	क,म,ला
jha,n,kaa,ye	झ,न,का,ये
pa,r	प,र
sha,r,maa,na	श,र,मा,ना
pu,r,jaa	पु,र,जा
pa,r,chhaa,i,yon	प,र,छा,इ,यों
ka,ya,laa,ta	ख़,या,ला,त
ga,la,ti	ग,ल,ती
ka,haa,ni,n	क,हा,नि,याँ
raa,ni,n	रा,नि,याँ
ne,ye,da	ने,एं,द
laa,yi	ला,ई
5,5	5,4,5
bhi,go,yi	भि,गो,ई
dha,n,ba,la	ध,न,ब,ल
gu,ma,su,ma	गु,म,सु,म
aa,yuu	आ,यूँ
mi,ta,taa	मि,ट,ता
di,la,vaa,lo	दि,ल,वा,लो
di,la,vaa,le	दि,ल,वा,ले
ni,ya,r	नि,य,र
paa,o,nge	पा,ओ,गे
paa,o,gi	पा,ओ,गी
aa,i,ti	आ,इ,टी
jhu,laa,n,gi	झु,ला,ऊँ,गी
gau,ron	गौ,रों
si,la,va,ta	सि,ल,व,ट
shi,ka,vaa	शि,क,वा
ka,ha,laa,ye	क,ह,ला,ए
ha,r,da,ma	ह,र,द,म
to,ha,fe	तो,ह,फ़े
ko	को
sa,laa,mi,n	स,ला,मि,याँ
di,vaa,n,gi	दी,वा,न,गी
u,n,se	उ,न,से
thu,ma,ke,gi	ठु,म,के,गी
i,ta,raa,ye	इ,त,रा,ये
ka,ha,laa,ye,gaa	क,ह,ला,ए,गा
sa,ma,jho,nge	स,म,झो,गे
be,ho,shi,n	बे,हो,शि,याँ
bi,n,ti	बि,न,ती
shri	श्री
u,pa,va,n	उ,प,व,न
du,aa,ye	दु,आ,एं
u,sa,me	उ,स,मे
u,sa,me	उ,स,में
ta,da,paa,n,gaa	त,ड़,पा,ऊँ,गा
ye,ha,saa,n	ए,ह,सा,न
fa,r,haa,da	फ़,र,हा,द
ye,ha,saa,sa	ए,ह,सा,स
a,fa,saa,na	अ,फ़,सा,ना
ma,r,ke	म,र,के
da,ri,ya	द,रि,या
li,ji,ye	ली,जि,ए
du,ri,n	दू,रि,याँ
du,ri,n	दू,री,याँ
a,ma,ri,ki	अ,म,री,की
nau,ja,n	नौ,ज,वाँ
si,taa,re	सि,ता,रे
ba,la,ki	ब,ल,की
mu,jha,me	मु,झ,में
si,taa,re	सि,ता,रे
jaa,n,gaa	जा,ऊँ,गा
ma,n,zi,la	म,न,ज़ि,ल
dha,da,ka,taa	ध,ड़,क,ता
n,ha,le	न,ह,ले
ba,ta,lau,gaa	ब,त,लौं,गा
a,pa,ne,pa,n	अ,प,ने,प,न
bha,ga,vaa,n	भ,ग,वा,न
na,choo	ना,चूँ
u,thaa,ye	उ,ठा,एँ
gu,ja,te	गूं,ज,ते
u,ga,ne	उ,ग,ने
kaa,ya,na,ta	का,य,ना,त
qaa,ya,na,ta	क़ा,य,ना,त
saa,ya,ma	सा,य,मं,ड्स
saa,re	सा,रे
ka,la,paa,o	क,ल,पा,ओ
r,he	र,हे
ma,ha,boo,ba	म,ह,बू,ब
aa,r,zu	आ,र,ज़ू
ba,ha,laa,ye	ब,ह,ला,ए
ba,la,khaa,na	ब,ल,खा,ना
pra,ti,yo,gi,taa	प्र,ति,यो,गि,ता
sa,pa,no	स,प,नो
u,thaa,n,gi	उ,ठा,ऊँ,गी
ya,haa	य,हाँ
be,ha,ta,ri,n	बे,ह,त,री,न
bi,thaa,yuu,gi	बि,ठा,ऊं,गी
se,lu,laa,yi,ta	से,लु,ला,ई,ट
raa,ja,poo,ta	रा,ज,पू,त
a,mbu,aa	अ,म्बु,आ
pi,ka,ni,ka	पि,क,नि,क
frie,chaa,i,za	फ्रें,चा,इ,ज़
gha,di,n	घ,ड़ि,याँ
ju,daa,yi	जु,दा,ई
chu,pa,ke	चु,प,के
chhu,pa,ke	छु,प,के
pa,hu,chaa,ye	प,हुँ,चा,ए
baa,rg,li	बा,र्ग,ली
paa,yi	पा,ईं
laa,gha,ne	लाँ,घ,ने
ba,na,ye,nge	ब,ना,एं,गे
ro,ke	रो,के
ya,da	या,द
dha,n,ba,la	ध,न,ब,ल
ya,haa	य,हाँ
na,daa,ni,n	ना,दा,नी,याँ
shi,va,raa,ja	शि,व,रा,ज
la,ga,taa	ल,ग,ता
gha,ta,na	घ,ट,ना
di,khaa,n	दि,खा,ऊँ
gha,ta,ne	घ,ट,ने
ji,n,me	जि,न,में
ba,ka,vaa,sa	ब,क,वा,स
tu,yi	तु,ई
na,cho	ना,चो
pa,ha,noo	प,ह,नूँ
bi,chha,daa	बि,छ,ड़ा
bi,chha,de	बि,छ,ड़े
bi,chha,di	बि,छ,ड़ी
ha,vaa,ye	ह,वा,एं
u,la,jhaa,ye	उ,ल,झा,ये
jaa,ye	जा,एँ
pa,dhaa,o,gi	प,ढ़ा,ओ,गी
a,njaa,na	अ,न्जा,ना
sa,r,haa,ne	स,र,हा,ने
pa,laa,ni,ma,kka,ma	प,ला,नि,म,क्क,म
praa,na,li	प्रा,णा,ली
bi,sa,raa,ye	बि,स,रा,ए
bi,sa,raa,yi	बि,स,रा,ई
ga,tha,ba,dha,n	ग,ठ,बं,ध,न
mu,ma,ki,n	मु,म,कि,न
hai	हैं
u,pa,vaa,saa	उ,प,वा,सा
la,mba,yi	ल,म्बा,ई
ma,ha,kaa,ya	म,ह,का,या
ta,ka,raa,ke	ट,क,रा,के
gha,r,vaa,lon	घ,र,वा,लों
te,ja,pu,r	ते,ज,पु,र
u,thaa,n	उ,ठा,ऊँ
maa,n,taa	मा,न,ता
ma,ha,r,baa	म,ह,र,बाँ
u,ta,r,ne	उ,त,र,ने
pi,gha,laa	पि,घ,ला
sa,ta,rk,taa	स,त,र्क,ता
ghu,maa,yuu,gaa	घु,मा,ऊं,गा
jaa,yuu,gi	जा,ऊं,गी
me,i,cha	में,इ,च
de,kha,na	दे,ख,ना
ta,ka,ni,ki	त,क,नी,की
n,ga,mon	न,ग़,मों
jaa,n,kaa,ri	जा,न,का,री
la,gaa,yuu,gi	ल,गा,ऊं,गी
la,gaa,n,gi	ल,गा,ऊँ,गी
du,je	दू,जे
du,bo	डु,बो
du,bo,ye	डु,बो,ए
ja,la,von	ज,ल,वों
saa,ja,na	सा,ज,ना
aa,khi,r,kaa,r	आ,खि,र,का,र
ku,di,n	कु,ड़ि,याँ
su,la,jhaa,yi	सु,ल,झा,ई
sa,u,di	स,उ,दी
cha,ta,kaa,na	च,ट,का,ना
aa,pa,se	आ,प,से
so,cha,ke	सो,च,के
mi,laa,ke	मि,ला,के
mi,la,ke	मि,ल,के
ku,sha,la,taa	कु,श,ल,ता
di,khaa,ye,nge	दि,खा,एं,गे
den	दें
a,ma,ro	अ,म,रो
laa,da,li	ला,ड,ली
r,ti,n	र,ति,याँ
r,ti,ya	र,ति,या
u,la,te	उ,ल,टे
u,la,ti	उ,ल,टी
si,sa,ka,na	सि,स,क,ना
ye,ka,ye,ka	ए,क, ,ए,क
sha,r,maa,i,ye	श,र,मा,इ,ये
ma,staa,na	म,स्ता,ना
chaa,da,ni	चाँ,द,नी
la,cha,kaa,i,ye	ल,च,का,इ,ये
si	सी
ha,sa,r,ta	ह,स,र,त
na,daa	ना,दाँ
i,sa,pe	इ,स,पे
a,daa,yon	अ,दा,ओं
ha,la,ki	ह,ल,की
a,ba,laa	अ,ब,ला
a,ga,daa,yi	अं,ग,ड़ा,ई
ha,la,kaa	ह,ल,का
ka,hoo	क,हूँ
kyo	क्यों
i,ta,raa,yi	इ,त,रा,ई
u,chha,lo	उ,च्छ,लो
ko,i,yi	को,इ,ई
ko,yi	को,ई
kho,yi	खो,ई
ko,i	को,इ
ko,ye	को,ए
a,n,pa,dha	अ,न,प,ढ़
pa,da,bhaa,r	प,द,भा,र
ba,taa,ye,nge	ब,ता,एं,गे
laa,o,nge	ला,ओ,गे
pa,ti,yon	प,ति,यों
jaa,na	जा,ना
ma,ha,kaa	म,ह,का
mu,ka,n	मू,ल्यां,क,न
kaa,sa	का,स
ka,ro,da	क,रो,ड़
ki,sa,li,ye	कि,स,लि,ए
vaa,li	वा,ली
ki,ya	कि,या
ko	‘,को
ko,yi	को,ई
sa,ba,ke	स,ब,के
sa,ba,ki	स,ब,की
ke,vi	के,वी
ko,yi	को,ई
sa,ka,taa	स,क,ता
sa,ba,kaa	स,ब,का
sa,ba,ke	स,ब,के
ga,vaa,ye	ग,वा,येँ
a,dha,mu,yi	अ,ध,मु,ई
gi,re,baa	गि,रे,बाँ
pa,re,shaa	प,रे,शाँ
pa,ri,shaa	प,री,शाँ
ta,ki,n	ट,कि,याँ
ma,ja,boo,ri,ya	म,ज,बू,रि,या
jhu,koo	झु,कूँ
a,ma,r,ta	अ,म,र,त
ba,ka,vaa,sa	ब,क,वा,स
raa,ma,ji	रा,म,जी
sho,khi,n	शो,खि,याँ
sho,ki,n	शो,ख़ि,याँ
mu,sku,raa	मु,स्कु,रा
bi,ta,te	बी,त,ते
chaa,r	चा,र
ba,lai,n	ब,लै,याँ
ka,laa,i,yaan	क,ला,इ,यां
pa,la,ke	प,ल,कें
ba,na,ye	ब,ना,ए
ba,na,o	ब,ना,ओ
ba,na,yi	ब,ना,ई
su,haa,ni,i	सु,हा,नी,इ
ma,ma,taa	म,म,ता
aa,sa,n	आ,स,ताँ
ha,la,vaa	ह,ल,वा
ka,ja,raa,re	क,ज,रा,रे
du,aa,yon	दु,आ,ओं
ka,ja,raa,ri	क,ज,रा,री
re,ji,me,ta	रे,जि,में,ट
ma,da,ma,sta	म,द,म,स्त
jaa,n	जा,ऊँ
ka,ha,taa	क,ह,ता
du,ri,n	दू,रि,याँ
du,ri,ya	दू,रि,या
aa,sa,maa	आ,स,माँ
u,n,kaa	उ,न,का
sa,ga,ma,r,ma,r	सं,ग,म,र,म,र
mu,sa,kaa,o,nge	मु,स,का,ओ,गे
ma,ha,kaa,ye	म,ह,का,ए
u,daa,ye	उ,ड़ा,ए
u,daa,o	उ,ड़ा,ओ
ma,ha,ki	म,ह,की
ma,ha,ke	म,ह,के
dha,li	धुँ,ध,ली
gha,ba,raa,n	घ,ब,रा,ऊँ
ma,gaa,yi	मँ,गा,ई
bu,jhaa,n	बु,झा,ऊँ
khe,la,n,haa,r	खे,ल,न,हा,र
faa,ya,daa	फा,य,दा
faa,ya,de	फा,य,दे
ba,ga,laa	बँ,ग,ला
ta,la,vaa,ron	त,ल,वा,रों
di,khaa,o,gi	दि,खा,ओ,गी
pre,ma	प्रे,म
ke,ndra	कें,द्र
di,khaa,o,nge	दि,खा,ओ,गे
laa,o,nge	ला,ओ,गे
ma,ga,di	मं,ग,दी
ma,chha,li	म,छ,ली
ja,la,ka,r	ज,ल,क,र
gha,ba,raa,ye	घ,ब,रा,ये
ro,ye	रो,एं
bi,chhaa,du	बि,छा,दूँ
ta,qa,di,r	त,क़,दी,र
i,raa,daa	इ,रा,दा
a,ka,don	आं,क,ड़ों
ga,ha,raa,yi	ग,ह,रा,ई
daa,sa,se	डा,स,से
di,la,daa,r	दि,ल,दा,र
ma,ta,ka,ne	म,ट,क,ने
pa,chha,taa,o,nge	प,छ,ता,ओ,गे
pu,ta,le	पु,त,ले
pa,chha,taa,o,gi	प,छ,ता,ओ,गी
bo,li,n	बो,लि,याँ
li,khuu	लि,खूँ
ma,na,yuu,gaa	म,ना,ऊं,गा
di,laa,yi	दि,ला,ई
ba,da,gu,maa	ब,द,गु,मां
u,daa,n,gaa	उ,ड़ा,ऊँ,गा
ma,o,r	म,न्ज़ो,ओ,र
pi,laa,ye	पि,ला,ए
pi,laa,yi	पि,ला,ई
aa,r,zu	आ,र,ज़ू
ji,yuu,gaa	जि,यूँ,गा
ra,gi,n	रं,गी,न
ba,r,son	ब,र,सों
chha,la,kaa	छ,ल,का
me,ha,taa,bi	मे,ह,ता,बी
ha,ma,laa	ह,म,ला
jaa,noo	जा,नूँ
so,zaa	सो,ज़ाँ
ta,r,shaa	त,र,शा
i,sa,li,ye	इ,स,लि,ए
ji,ta,ni	जि,त,नी
sa,he,li,yon	स,हे,लि,यों
yu,vaa,yon	यु,वा,ओं
ja,luu	ज,लूँ
ju,ga,nu,yon	जु,ग,नु,ओं
ga,ha,raa,yi	ग,ह,रा,ई
khu,sha,boo	खु,श,बू
khu,shbu,ye	खु,श्बु,एं
bhaa,jaa,paa,yi	भा,जा,पा,ई
bi,ye,la,si,o	बी,ए,ल,सी,ओ
ru,swaa,yi	रु,स्वा,ई
ru,sa,vaa,yi	रु,स,वा,ई
ji,n,ki	जि,न,की
ji,n,ko	जि,न,को
ji,n,kaa	जि,न,का
ji,n,ke	जि,न,के
ju,daa,ye	जु,दा,ए
ya,ri,n	या,रि,याँ
ju,daa,yi	जु,दा,ई
jaa	जाँ
bha,ga,vaa,n	भ,ग,वा,न
	c,a,n,n,o,t, ,u,n,d,e,r,s,t,a,n,d
jaa,ye	जा,ए
jaa	जा
jaa,yi	जा,ई
jaa	जाँ
jaa	जा
jaa,o	जा,ओ
jaa,n	जा,ऊँ
jaa,n	जा,न
do,li,ya	डो,लि,या
ka,raa,ya	क,रा,या
u,da,taa	उ,ड़,ता
di,khaa,o	दि,खा,ओ
be,ha,ya,yon	बे,ह,या,ओं
i,kaa,i,yon	इ,का,इ,यों
a,ma,ri,ki	अ,म,री,की
pa,r,chhaa,yi	प,र,छा,ई
ha,vaa,ye	ह,वा,एं
da,r,vaa,je	द,र,वा,जे
fa,r,va,ri	फ़,र,व,री
ha,sa,te	हँ,स,ते
su,na,n	सु,ना,ऊँ
su,na,o	सु,ना,ओ
ba,na,ya	ब,ना,या
ga,r,mi	ग,र,मी
chho,di,ye	छो,ड़ि,ए
ka,ma,li,ni	क,म,लि,नी
a,ja,n,bi	अ,ज,न,बी
ba,la,ma,vaa	ब,ल,म,वा
aa,za,maa,ti	आ,ज़,मा,ती
chhu,ri,n	छु,रि,याँ
la,ha,raa,ye,gi	ल,ह,रा,ए,गी
ka,shti,n	क,श्ति,याँ
chho,da,ne	छो,ड़,ने
ga,li,yo,n,me	ग,लि,यो,न,मे
pyaa,ja	प्या,ज
ba,chaa,ye	ब,चा,एं
mi,la,ti	मि,ल,ती
ma,haa,pra,ba,dha,ka	म,हा, ,प्र,बं,ध,क
sa,ma,sya,yon	स,म,स्या,ओं
ha,ma,saa,ya	ह,म,सा,या
mu,ska,raa,ye	मु,स्क,रा,एँ
ka,pa,daa	क,प,ड़ा
ba,dhaa,o	ब,ढ़ा,ओ
ba,dhaa,yi	ब,धा,ई
ma,ta,vaa,li,n	म,त,वा,लि,याँ
chhe,doo	छे,ड़ूँ
mu,ska,raa,yi	मु,स्क,रा,ई
mu,ska,raa,ye	मु,स्क,रा,ए
gu,n,gu,na,ne	गु,न,गु,ना,ने
chhu,paa,ye,nge	छु,पा,एं,गे
fai,sa,laa	फ़ै,स,ला
mu,ska,raa,ye,nge	मु,स्क,रा,एं,गे
la,la,chaa,yi	ल,ल,चा,ई
sa,bhaa,va,na	सं,भा,व,ना
ta,pa,taa	त,प,ता
ta,pa,ti	त,प,ती
ta,da,pa,taa	त,ड़,प,ता
ta,da,pa,te	त,ड़,प,ते
dhu,n,vaa,n	धु,न,वा,न
1,6	1,9,8,6
ta,da,paa,le	त,ड़,पा,ले
ha,ma,da,rdi	ह,म,द,र्दी
sa,ta,n	सं,त,न
a,ke,li,n	अ,के,लि,याँ
ka,laa,yi	क,ला,ई
mi,chau,li,n	मि,चौ,लि,याँ
	8,9
shri,ma	श्री,म,द्,‍
mi,n,ta,',sa	मि,न,ट,’,स
saa,va,ri	साँ,व,री
do	8,2
ma,sa,la,te	म,स,ल,ते
i,sa,ki	इ,स,की
ka,hoo	क,हूँ
noo	नूँ
mo,r,ni	मो,र,नी
ka,ha,ke	क,ह,के
bhi,ya	भै,या
bhaa,jaa,paa,yi	भा,जा,पा,ई
aa,vaa,ja,me	आ,वा,ज,मे
gha,ba,raa,na	घ,ब,रा,ना
do,sau,sau,5,6	2,0,0,5, ,6
sthi,ti	स्थि,ति
jaa,i,ye	जा,इ,ये
a,ha,ma,daa,baa,da	अ,ह,म,दा,बा,द
jaa,yi,daa	जा,ई,दा
pa,ti,yon	प,ति,यों
ha,sa,ke	हं,स,के
ha,sa,ke	हँ,स,के
a,rmaan	अ,र्मां
a,r,maa	अ,र,माँ
gu,la,mo,ha,r	गु,ल,मो,ह,र
khi,cha,ti	खि,च,ती
ha,ma,da,rd	ह,म,द,र्द
kaa,baa,ta,raa	का,बा,त,राँ
ru,sa,vaa,yi	रु,स,वा,ई
ma,cha,le	म,च,ले
ni,bhaa,n,gaa	नि,भा,ऊँ,गा
ga,ja,re	ग,ज,रे
ga,ja,raa	ग,ज,रा
n,hi	न,ही
sho,ki,n	शो,ख़ि,याँ
jaa,i,ye,gaa	जा,इ,ये,गा
be,cha,ka,r	बे,च,क,र
kho,pa,di	खो,प,ड़ी
va,faa,ye	व,फ़ा,एँ
na,i,nsaa,fi	ना,इ,न्सा,फ़ी
ha,ma,n,shi	ह,म,न,शी
aa,jaa,ye,gaa	आ,जा,ए,गा
chha,ta,ri	छ,त,री
gu,pa,chu,pa	गु,प,चु,प
faa,sa,laa	फ़ा,स,ला
faa,sa,le	फ़ा,स,ले
faa,sa,le	फ़ा,स,लें
n,nge	ताँ,गे
ri,jhaa,o	रि,झा,ओ
paa,ga,la,pa,n	पा,ग,ल,प,न
kyaa,lon	ख़्या,लों
khya,lon	ख्या,लों
aa,r,zo,o	आ,र,ज़ो,ओ
i,sa,ku,la	इ,स,कू,ल
ma,da,maa,ti	म,द,मा,ती
su,ni,yo	सु,नि,यो
chaa,ndni	चां,द्नी
a,n,ga,na	अ,न,ग,ना
taa,baa	ता,बाँ
ni,rya,ta,ka	नि,र्या,त,क
r	ह्जा,र
gho,la,taa	घो,ल,ता
ha,saa,ye,nge	ह,सा,एं,गे
gaa,u,gi	गा,उँ,गी
vi,raa,ni,n	वी,रा,नि,याँ
gi,noo	गि,नूँ
su,koo	सु,कूँ
ru,pa,ye	रु,प,ए
kaa,li,n	का,लि,याँ
raa,gha,va,ga,dha	रा,घ,व,ग,ढ़
ka,r,taa	क,र,ता
ve,tta,yon	वे,त्ता,ओं
ja,la,ke	ज,ल,के
ni,n,yi,ni,saa,sa,saa,re	नि,न,ई,नि,सा,स,सा,रे
a,ndhe,re	अं,धे,रे
bha,va,re	भँ,व,रे
pa,ta,n,ga	प,त,न,ग
mi,la,te	मि,ल,ते
mi,la,tein	मि,ल,तें
mi,la,ti	मि,ल,ती
mi,la,taa	मि,ल,ता
mi,la,ti	मि,ल,ती
la,ha,raa,ne	ल,ह,रा,ने
chhaa,ye	छा,ए
be,sa,ha,raa,ma	बे,स,ह,रा,म
chhaa,yi	छा,ई
chaa,da	चाँ,द
ju,baa,ya,daa	जु,बा,य,दा
qi,sma,ta	क़ि,स्म,त
sa,r,ga,ma	स,र,ग,म
di,ta,taa	दी,त,ता
gha,r,vaa,li	घ,र,वा,ली
r,ha,ti	र,ह,ती
r,maa,ye,nge	र,मा,एं,गे
ha,sa,r,tein	ह,स,र,तें
ka,sa,ne	क,स,ने
kri,sa,ma,sa	क्रि,स,म,स
aa,i,si,ti	आ,इ,सी,टी
ba,ja,ti	ब,ज,ती
r,hoo	र,हूँ
qa,ta,laa	क़,त,लाँ
be,qa,raa,ri,n	बे,क़,रा,रि,याँ
ba,ja,taa	ब,ज,ता
gu,za,ru	गु,ज़,रूँ
gu,zaa,ru	गु,ज़ा,रूँ
jaa,ye	जा,ए
maa,ha,taa,ba	मा,ह,ता,ब
u,tha,te	उ,ठ,ते
ga,za,daa	ग,ज़,दाँ
chhu,aa	छु,आ
i,n,me	इ,न,में
chaa,hoo	चा,हूँ
a,ye,ho	अ,ए,हो
vaa,sa,taa	वा,स,ता
n,hin	न,हीं
ne,r	ने,र
maa,ma,le	मा,म,ले
maa,ma,laa	मा,म,ला
a,dhya,ya,n	अ,ध्य,य,न
tu,ma,ne	तु,म,ने
bi,ka,ne	बि,क,ने
jaa,ne,ja,haa	जा,ने,ज,हाँ
ka,saa,yi	क,सा,ई
ta,ka,li,fa	त,क,ली,फ़
gaa,n,gaa	गा,ऊँ,गा
a,va,ga,ta	अ,व,ग,त
ni,shaa	नि,शाँ
pi,ye,ma,ye,sa	पी,ए,म,ए,स
laa,i,ye	ला,इ,ये
sa,da,bu,ddh	स,द,बु,द्ध
ba,taa,li,ya,n	ब,टा,लि,य,न
aa	आ,स्ताँ
n,ga,ri	न,ग,री
n,fa,r,tein	न,फ़,र,तें
ta,laa,sha,me	त,ला,श,मे
la,pa,taa,yo	ल,प,टा,यो
gu,n,gu,na,ye,gi	गु,न,गु,ना,ये,गी
kha,n,ke	ख,न,के
na,za,ni,n	ना,ज़,नी,न
na,za,nee	ना,ज़,नीं
r,ma,taa	र,म,ता
ka,r,ja,vaa	क,र,ज,वा
aa,n,gi	आ,ऊँ,गी
be,i,maa,ni	बे,इ,मा,नी
a,shru,da,r,kt	अ,श्रु, ,स्वे,द, ,र,क्त
bo,le	बो,ले
r,ha,gu,za,r	र,ह,गु,ज़,र
r,ha,gu,ja,r	र,ह,गु,ज,र
ni,bhaa,o	नि,भा,ओ
khaa,mo,shi,n	खा,मो,शि,याँ
ti,r,chhi	ति,र,छी
ti,r,chhe	ति,र,छे
ju,sa,ta,ju	जू,स,त,जू
r,kha,te	र,ख,ते
dho,la,na	ढो,ल,ना
do,la,na	डो,ल,ना
si,ta,ma,ga,r	सि,त,म,ग,र
a,n,va,r	अ,न,व,र
ma,ya,ka,sha	म,य,क,श
ma,ha,gaa	म,हँ,गा
raa,ste	रा,स्ते
sa,rg,ma	स,र्ग,म
hu,ye	हु,ए
hu,aa	हु,आ
hu,ye	हु,ए
hu,a	हु,अ
hoo	हूँ
hu	हुँ
ho	हो
hu,yi	हु,ई
suu,la,jaa	सू,ल,जा
khaa,yi	खा,ईं
gi,ta,vaa	गि,त,वा
pa,r,chhaa,yi	प,र,छा,ईं
aa,r	आ,र
pa,n,haa,ri,n	प,न,हा,रि,याँ
se,vaa,ye	से,वा,एँ
a,ba,ke	अ,ब,के
jhi,la,mi,la	झि,ल,मि,ल
hai,raa,n	है,रा,न
de,va,raa,ni,ji	दे,व,रा,नी,जी
a,ta,khe,li,n	अ,ट,खे,लि,याँ
a,n,kha,li,n	अ,न,ख,लि,याँ
baa,ha,r	बा,ह,र
sa,da,sya	स,द,स्य
daa,staan	दा,स्तां
ba,ta,laa,de	ब,त,ला,दे
sa,mbha,le,gaa	स,म्भ,ले,गा
bha,ta,ka,ne	भ,ट,क,ने
kho,ye,nge	खो,एं,गे
gaa,li,n	गा,लि,याँ
du,kha,daa	दु,ख,ड़ा
gha,ba,raa,ke	घ,ब,रा,के
ki,sa,kaa	कि,स,का
phu	फु,ल्लाँ
ba,dho,tta,ri	ब,ढ़ो,त्त,री
la,daa,n,gaa	ल,ड़ा,ऊँ,गा
chu,la,bu,li	चु,ल,बु,ली
sa,jaa,i,le	स,जा,इ,ले
a,va,she,sha	अ,व,शे,ष
ba,da,na,mi	ब,द,ना,मी
pa,r,mpa,raa	प,र,म्प,रा
baa,rg,li	बा,र्ग,ली
chuu,ma,ti	चू,म,ती
chuu,ma,te	चू,म,ते
jaa,ye	जा,ए
ma,ta,vaa,li	म,त,वा,ली
daa,la,ka,r	डा,ल,क,र
bhaa,jaa,paa,yi	भा,जा,पा,ई
ma,na,ye,nge	म,ना,एं,गे
che,ha,ron	चे,ह,रों
n,za,di,ka	न,ज़,दी,क
n,ye,ka	न,ज़्दे,ए,क
ku,ta,r,ti	कु,त,र,ती
ga,ha,na	ग,ह,ना
ba,jaa,r,n	बं,जा,र,न
ma,ha,ka,ne	म,ह,क,ने
phi,r,taa	फि,र,ता
phi,r,te	फि,र,ते
phi,r,ti	फि,र,ती
pi,gha,la,taa	पि,घ,ल,ता
ka,ta,raa	क,ट,रा
kha,ta,raa	ख,त,रा
au,r	औ,र
yon	ओं
kra,ma	क्र,म
ka,rma	क,र्म
o,u,ta	ऑ,उ,ट
sa,ma,jhaa,na	स,म,झा,ना
su,r,ji,ta	सु,र,जी,त
raa,ja,ni,ti,ka	रा,ज,नी,ति,क
ju,aa	जु,आ
ye,ka,ju,ta	ए,क,जु,ट
ja,la,se	ज,ल,से
si,bi,aa,i	सी,बी,आ,इ
jaa,n	जा,ताँ
be,ha,ta,ri,n	बे,ह,त,री,न
ka,rma	क,र्म
ba,r,saa,tein	ब,र,सा,तें
saa,sa	साँ,स
u,pa,sa,r,pa,cha	उ,प,स,र,पं,च
ta,r,saa,taa	त,र,सा,ता
jhaa,bu,aa	झा,बु,आ
ta,ka,raa,ti	ट,क,रा,ती
pra,ti,yo,gi,taa	प्र,ति,यो,गि,ता
maa,ga,ti	माँ,ग,ती
dha,da,kaa,o	ध,ड़,का,ओ
ma,sa,taa,ni	म,स,ता,नी
sa,mha,la,ke	स,म्ह,ल,के
ki,ya	कि,या
a,pa,na,ye,nge	अ,प,ना,एं,गे
i,n,se	इ,न,से
paa,n,gaa	पा,ऊँ,गा
mai,n	मै,याँ
da,vaa	द,वा
baa,ju,yon	बा,जु,ओं
ni,shaa,ni,n	नि,शा,नि,याँ
gha,di,n	घ,ड़ि,याँ
koo,bi,n	ख़ू,बि,याँ
r,ta,ja,nge	र,त,ज,गे
laa,goo	ला,गूँ
ha,la,ke	ह,ल,के
ta,ka,raa,ye,gaa	ट,क,रा,ए,गा
sha,ta,ra,ja	श,त,रं,ज
ja,nma,stha,li	ज,न्म,स्थ,ली
ka,rma	क,र्म
lu,ta,ka,r	लू,ट,क,र
gu,n,gu,na,ti	गु,न,गु,ना,ती
pa,ha,na,te	प,ह,ना,ते
a,dhya,ksha,taa	अ,ध्य,क्ष,ता
u,tpaa,da,ka,taa	उ,त्पा,द,क,ता
pa,ha,raa	प,ह,रा
r,cha,na,kaa,ron	र,च,ना,का,रों
ta,r,sa,na	त,र,स,ना
ha,vaa,le	ह,वा,ले
i,kaa,i,yon	इ,का,इ,यों
gu,za,r,taa	गु,ज़,र,ता
gu,za,r,ti	गु,ज़,र,ती
mi,la,ju,la	मि,ल,जु,ल
hi,cha,ki,yon	हि,च,कि,यों
a,da,taa,li,sa	अ,ड़,ता,ली,स
cha,ka,lon	च,क,लों
zu,baa	ज़ु,बाँ
za,baa	ज़,बाँ
ko,ri,ya	को,रि,या
pa,r,vaa,za	प,र,वा,ज़
pa,r,vaa,ha	प,र,वा,ह
sa,taa,n,gi	स,ता,ऊँ,गी
sa,taa,yuu,gi	स,ता,ऊं,गी
ba,la,khaa	ब,ल,खा
du	दूँ
shaa,ha	शा,ह
du,aa	दु,आ
pa,r	प,र
a,ha,ma,daa,baa,da	अ,ह,म,दा,बा,द
jhu,ma,kaa	झु,म,का
jhuu,ma,ka,r	झू,म,क,र
u,se	उ,से
raa,ja,swa	रा,ज,स्व
la,mbe	ल,म्बे
r,ha,taa	र,ह,ता
dhaa,yi,sau	ढा,ई,सौ
taa,n,te	ता,न,ते
pai,n	पै,याँ
vi,dhaa,n,sa,bhaa	वि,धा,न,स,भा
u,tha,ne	उ,ठ,ने
ha,ma,saa	ह,म,सा
la,ta,kaa,ya	ल,ट,का,या
ha,sa,taa	हँ,स,ता
re,khaa,yon	रे,खा,ओं
ni,haa,ru	नि,हा,रूँ
su,na,yi	सु,ना,ई
su,na,n	सु,ना,ऊँ
su,na,o	सु,ना,ओ
va,faa,ye	व,फ़ा,एँ
khi,laa,ye,gaa	खि,ला,ए,गा
u,la,jhaa,o,nge	उ,ल,झा,ओ,गे
pra,ga,n	प्रां,ग,ण
mi,thaa,yi	मि,ठा,ई
frie,chaa,i,za	फ्रें,चा,इ,ज़
sha,r,maa,ne,vaa,le	श,र,मा,ने,वा,ले
de,va,taa,yon	दे,व,ता,ओं
traa,va,n,ko,r	ट्रा,व,ण,को,र
ba,cha,ke	ब,च,के
a,ka,sa,r	अ,क,स,र
u,bha,re	उ,भ,रे
di,kha,laa,o	दि,ख,ला,ओ
u,la,jha,n	उ,ल,झ,न
mi,khaa,i,la	मि,खा,इ,ल
ji,n,pa,r	जि,न,प,र
mu,khya	मु,ख्य
ma,na,n	म,ना,ऊँ
pa,hchaa,n,te	प,ह्चा,न,ते
ga,ha,raa,i,yon	ग,ह,रा,इ,यों
i,ta,zaa,r	इं,त,ज़ा,र
baa,r,haa	बा,र,हा
ma,ja,boo,r	म,ज,बू,र
r,ta,laa,ma	र,त,ला,म
ba,ha,ki	ब,ह,की
ja,li,n	ज,लि,याँ
chha,la,ka,te	छ,ल,क,ते
bhi,ga,taa	भी,ग,ता
maa	माँ
ti,sa,re	ती,स,रे
pa,chha,taa,ye	प,छ,ता,ये
vi,dhaa,n,sa,bhaa	वि,धा,न,स,भा
ti,sa,raa	ती,स,रा
jaa,ne	जा,ने
ti,sa,ri	ती,स,री
ba,laa,ye	ब,ला,एँ
ye,ka,saa	ए,क,सा
ma,ta,vaa,laa	म,त,वा,ला
ma,ta,vaa,li	म,त,वा,ली
ba,r,saa,ton	ब,र,सा,तों
ba,r,saa,ti	ब,र,सा,ती
ba,r,saa,tein	ब,र,सा,तें
ba,r,saa,taa	ब,र,सा,ता
ji,yu,gi	जि,यूं,गी
aa,shaa,yon	आ,शा,ओं
na,choo	ना,चूँ
mi,khaa,i,la	मि,खा,इ,ल
sa,mthi,ga	स,म्तिं,ग
da,ri,n	द,रि,याँ
ju,baa,ya,daa	जु,बा,य,दा
aa,za,maa,ne	आ,ज़,मा,ने
khu,sha,boo	खु,श,बू
sa,gaa,yi	स,गा,ई
vaa,le	वा,ले
vaa,lo	वा,लो
bhu,laa,n	भु,ला,ऊँ
ka,hin	क,हीं
ji,nda,gi	जि,न्द,गी
maa,ta,ra	मा,त,रं
jaa,o,gi	जा,ओ,गी
sa,ma,sya,yon	स,म,स्या,ओं
ja,n,taa	ज,न,ता
jaa,n,taa	जा,न,ता
jaa,n,te	जा,न,ते
ja,n,ti	ज,न,ती
n,ha,laa,ye	न,ह,ला,ए
ne,taa,yon	ने,ता,ओं
ka,ha,taa	क,ह,ता
ka,ha,te	क,ह,ते
ka,ha,ti	क,ह,ती
de,ha,raa,du,n	दे,ह,रा,दू,न
dha,r,ne	ध,र,ने
ka,ru	क,रूँ
ha,vaa,yi	ह,वा,ई
aa,n,gaa	आ,ऊँ,गा
aa,yuu,gaa	आ,ऊं,गा
ba,na,ye	ब,ना,एँ
bi,chhu,aa	बि,च्छु,आ
phu,la,vaa	फु,ल,वा
i,laa,ko	इ,ला,को
laa,li,n	ला,लि,याँ
ha,ma,tu,ma	ह,म,तु,म
a,r,ma,no,ki	अ,र,म,नो,की
pi,chle	पि,छ्ले
me,ha,raa	मे,ह,राँ
jaa,goo	जा,गूँ
ka,r,ne	क,र,ने
ma,za,ha,ba	म,ज़,ह,ब
ka,r,ti	क,र,ती
a,ga,daa,yi	अं,ग,ड़ा,ई
u,n,ki	उ,न,की
u,n,ke	उ,न,के
u,n,kaa	उ,न,का
too	तू,फ़ाँ
ba,ja,vaa,na	ब,ज,वा,ना
i,ta,ni	इ,त,नी
kaa,nu,non	का,नू,नों
khe,luu	खे,लूँ
la,da,na	ल,ड़,ना
la,da,ne	ल,ड़,ने
aa,khon	आँ,खों
aa,khon	आँ,खों
ta,ba,le	त,ब,ले
ta,ba,laa	त,ब,ला
khaa,yi	खा,ई
khaa,o	खा,ओ
khaa,ye	खा,ए
ha,ma	ह,म
ba,r,nsoo	ब,र,सूँ
haa,ri,n	हा,रि,याँ
du,vaa	दु,वा
du,aa	दु,आ
sa,r,ksha,n	सं,र,क्ष,ण
do,sau,sau,5	2,0,0,5
bhaa,r,ti,ya	भा,र,ती,य
pa,rya,pt	प,र्या,प्त
saa,sa,raa	सा,स,रा
ja,ma,ne	ज,म,ने
taa,yi	टा,ई
sa,ma,jhaa,ye	स,म,झा,ए
sa,ha,laa,o	स,ह,ला,ओ
sa,vi,chaa,r	स,द्,‍, ,वि,चा,र
fa,r,maa,ye	फ़,र,मा,यें
a,ba,se	अ,ब,से
za,khm	ज़,ख़्म
aa,fa,taa,ba	आ,फ़,ता,ब
gha,ba,raa,ti	घ,ब,रा,ती
gha,ba,raa,taa	घ,ब,रा,ता
gha,ba,raa,te	घ,ब,रा,ते
sa,da,sya	स,द,स्य
ki,ta,na	कि,त,ना
sa,da,son	स,द,स्यों
ka,ha,laa,taa	क,ह,ला,ता
dri,shti	दृ,ष्टि
ka,ha,laa,ti	क,ह,ला,ती
cha,ma,ka	च,म,क
ha,qa,daa,r	ह,क़,दा,र
mu,sku,raa,o	मु,स्कु,रा,ओ
i,ka,taa,re	इ,क,ता,रे
ja,n,va,ri	ज,न,व,री
thaa,ku,r,taa	ठा,कु,र,ता
ka,li,ga,n	क,लिं,ग,न
faa,u,de,sha,n	फा,उं,डे,श,न
chhaa,n,te	छा,न,ते
na,kaa,ma,ya,ba	ना,का,म,या,ब
jaa,n	जा,ऊँ
vri,ksho	वृ,क्षों
pa,laa,ni,ma,kka,ma	प,ला,नि,म,क्क,म
zaa,la,maa	ज़ा,ल,माँ
ta,r,se,gi	त,र,से,गी
ta,r,se,gaa	त,र,से,गा
jaa,du,yi	जा,दु,ई
ye,ka	ए,क
pra,ga,n	प्रां,ग,ण
r	र,क्साँ
jha,n,kaa,ren	झ,न,का,रें
kaa,ma,ya	का,म,या
chha,la,ke,gaa	छ,ल,के,गा
ji,sa,pe	जि,स,पे
be,zu,baa,ni,n	बे,ज़ु,बा,नि,याँ
sa,ha,na	स,ह,ना
mi,la,ka,r	मि,ल,क,र
a,va,sa,ron	अ,व,स,रों
fa,rmaa,o	फ़,र्मा,ओ
fa,r,maa,o	फ़,र,मा,ओ
fa,r,maa,n	फ़,र,मा,न
mu,sa,kaa,ti	मु,स,का,ती
do,ri,n	डो,रि,याँ
a,pa,na,pa,n	अ,प,ना,प,न
ja,la,von	ज,ल,वों
gu,n,gu,na,na	गु,न,गु,ना,ना
yi,maa	ई,माँ
pra,dhaa,n,ma,tri	प्र,धा,न,मं,त्री
jaa,n,gi	जा,ऊँ,गी
jaa,yuu,gi	जा,ऊं,गी
ru,ka,vaa	रु,क,वा
jaa,yuu,gaa	जा,ऊं,गा
jaa,n,gaa	जा,ऊँ,गा
chhu,paa,o,nge	छु,पा,ओ,गे
ba,sa,ti	ब,स,ती
sa,hyaa,ndri	स,ह्या,द्रि
ha,tu	ह,टूँ
sa,da,bu,ddh	स,द,बु,द्ध
faa,u,de,sha,n	फा,उं,डे,श,न
aa,n,gi	आ,ऊँ,गी
a,va,ga,ta	अ,व,ग,त
fi,ta,r,ta	फ़ि,त,र,त
ni,ka,le,nge	नि,क,लें,गे
n,za,di,ki,n	न,ज़,दी,कि,याँ
di,kha,ne	दि,ख,ने
bu,jhaa,ye	बु,झा,एँ
ba,da,li,yaan	ब,द,लि,यां
shra,ddha,lu,yon	श्र,द्धा,लु,ओं
ma,ha,suu,sa	म,ह,सू,स
ba,haa,r	ब,हा,र
ru,ka,ne	रु,क,ने
ru,ka,na	रु,क,ना
bi,ti,ya	बि,टि,या
lu,taa,yuu	लु,टा,ऊं
hi,r,ni	हि,र,णी
hi,r,ni	हि,र,नी
sho,ki,n	शो,ख़ि,याँ
ghu,le	घु,ले
di,n	दि,याँ
ba,dhaa,yi	ब,धा,ई
a,ga,ni	अ,ग,नी
pu,kaa,r,ka,r	पु,का,र,क,र
su,vi,dhaa,yon	सु,वि,धा,ओं
ka,rma	क,र्म
chhu,aa,chhu,yi	छु,आ, ,छु,ई
pra,ti,ba,ndh,taa,yon	प्र,ति,ब,न्ध,ता,ओं
su	सु,क़ूँ
pa,na,ho	प,ना,हो
maa,ha,taa,ba	मा,ह,ता,ब
to,li,n	टो,लि,याँ
laa,gha,ne	लाँ,घ,ने
ba,ha,laa	ब,ह,ला
u,daa,o	उ,ड़ा,ओ
u,daa,yi	उ,ड़ा,ई
u,daa,yi	उ,डा,ई
si,ne	सी,ने
daa,li,n	डा,लि,याँ
baa,ta,chi,ta	बा,त,ची,त
fa,r,maa,o	फ़,र,मा,ओ
sa,jaa,yi	स,जा,ई
sa,jaa,o	स,जा,ओ
baa,dha,ke	बां,ध,के
sa,jaa,ye	स,जा,ए
ba,dha,ti	ब,ढ़,ती
ba,dha,ti	ब,ढ़,ती
la,gaa,ya,ke	ल,गा,य,के
la,gaa,i,ke	ल,गा,इ,के
ba,dha,taa	ब,ढ़,ता
gu,di,ya	गु,ड़ि,या
di,laa,yuu	दि,ला,ऊं
ji,ya	जि,या
pa,da,ne	प,ड़,ने
pa,dha,ne	प,ढ़,ने
ba,haa,ron	ब,हा,रों
pa,da,na	प,ड़,ना
khi,la,chi,pu,r	खि,ल,चि,पु,र
gha,r,vaa,li	घ,र,वा,ली
hoo	हूँ
gha,r,vaa,le	घ,र,वा,ले
sa,saa,dha,n	सं,सा,ध,न
baa,ye	बा,एँ
baa,je	बा,जे
su,na	सु,ना,वूँ
to,da,ne	तो,ड़,ने
pa,r,chhaa,yi,yaan	प,र,छा,ई,यां
pa,r,chhaa,i,yaan	प,र,छा,इ,यां
a,raa,ja,pa,ntri,ta	अ,रा,ज,प,त्रि,त
ru,sa,vaa,i,yon	रु,स,वा,इ,यों
boo,da,n	बूं,द,न
ma,staa,ni,n	म,स्ता,नि,याँ
so,ye	सो,ए
so,yi	सो,ई
khaa,i,yo	खा,इ,यो
pa,ha,raa	प,ह,रा
ya,ko,yi	या,को,ई
sa,stha,non	सं,स्था,नों
aa,sa,maa	आ,स,माँ
da,r,vaa,zon	द,र,वा,ज़ों
ga,li,yaan	ग,लि,यां
bha,ta,kaa	भ,ट,का
vi,shva,na,th,n	वि,श्व,ना,थ,न
ma,chaa,o,nge	म,चा,ओ,गे
baa,ji,n	बा,जि,याँ
sa,pa,na	स,प,ना
kaa,pa,ne	काँ,प,ने
ta,r,saa,ti	त,र,सा,ती
jaa,noo	जा,नूँ
ma,ha,kaa	म,ह,का
ma,ha,ko	म,ह,को
ma,ha,ki	म,ह,की
saa	सा
ni,bhaa,yuu,gaa	नि,भा,ऊं,गा
si,ma,ti	सि,म,टी
ni,bhaa,yuu,gi	नि,भा,ऊं,गी
mi,khaa,i,la	मि,खा,इ,ल
do,la,taa	डो,ल,ता
do,la,ti	डो,ल,ती
ma,ta,vaa,lon	म,त,वा,लों
pyaa,sa	प्या,स
hi,cha,ki,chaa,na	हि,च,कि,चा,ना
paa,paa	पा,पा
ta,nhaa,yi,ya	त,न्हा,ई,या
ka,lle,n	क,ल्ले,याँ
paa,n,gaa	पा,ऊँ,गा
cha,ma,kaa,ya	च,म,का,या
vaa,ka,ye	वा,क,ये
u,thaa,n,gaa	उ,ठा,ऊँ,गा
jha,r,na	झ,र,ना
sa,da,bu,ddh	स,द,बु,द्ध
jha,r,ne	झ,र,ने
u,pa,haa,ron	उ,प,हा,रों
phe,r,ka,r	फे,र,क,र
sa,ma,jha,ti	स,म,झ,ती
sa,ma,jha,te	स,म,झ,ते
ye,sa,ti	ए,स,टी
di,la,gi,r	दि,ल,गी,र
	s,e
va,r,daa,n	व,र,दा,न
sa,da,bu,ddh	स,द,बु,द्ध
ma,r,ne	म,र,ने
pa,ha,laa	प,ह,ला
pa,ha,le	प,ह,ले
pa,ha,li	प,ह,ली
bu,raa,yi	बु,रा,ई
cha,la,na	च,ल,ना
bho,paa,la	भो,पा,ल
ma,ga,la,mu,rti	मं,ग,ल,मू,र्ति
a,sa,raa,ni	अ,स,रा,नी
ka,ru	क,रूँ
bu,jhaa,o,nge	बु,झा,ओ,गे
nau,haa,ga,raa	नौ,हा,ग,राँ
u,pa,la	उ,प,ल,ब्धी
1,7,3	1,9,7,3
u,la,jhaa,ye	उ,ल,झा,ए
di,la,ru,baa,yi	दि,ल,रु,बा,ई
bha,ta,kaa,ye	भ,ट,का,ये
hai,da,raa,baa,di	है,द,रा,बा,दी
sa,ma,jhaa,yi	स,म,झा,ई
su,na,o,nge	सु,ना,ओ,गे
mu,ka,r,na	मु,क,र,ना
raa,to,i,n	रा,टो,इ,न
kaa,rya,kra,ma	का,र्य,क्र,म
khi,le	खि,ले
khi,le	खि,ले
thi,r,ka,taa	थि,र,क,ता
mi,khaa,i,la	मि,खा,इ,ल
pi,chhe,ye	पी,छे,ए
gu,la,si,taan	गु,ल,सि,तां
gu,la,si,taa,n	गु,ल,सि,ता,न
gu,lsi,n	गु,ल्सि,ताँ
gu,lsi,taa	गु,ल्सि,ता
sha,ha,na,i,yon	श,ह,ना,इ,यों
a,ha,ma,da	अ,ह,म,द
va,r,na	व,र,ना
ma,ya,ss,r	म,य,स्स,र
ni,bhaa,yi	नि,भा,ई
la,th,pa,th	ल,थ,प,थ
u,thaa,ye	उ,ठा,एं
va,r,daa,n	व,र,दा,न
chi,ta,va,n	चि,त,व,न
ba,ta,laa,n	ब,त,ला,ऊँ
gha,ba,raa,i,ye	घ,ब,रा,इ,ये
ya,raa,na	या,रा,ना
ba,jaa,n,gaa	ब,जा,ऊँ,गा
a,pa,non	अ,प,नों
la,gaa,ye	ल,गा,एँ
vaa,ja,pe,yi	वा,ज,पे,यी
bhaa,jaa,paa,yi	भा,जा,पा,ई
maa	मां
pa,chha,taa,na	प,छ,ता,ना
shaa,ya,raa,na	शा,य,रा,ना
saa,ki	सां,ख्यि,की
aa,da,mi	आ,द,मी
ba,saa,n,gi	ब,सा,ऊँ,गी
ba,saa,yuu,gaa	ब,सा,ऊं,गा
baa,la,kon	बा,ल,कों
pa,ha,lu	प,ह,लू
qa,sa,me	क़,स,में
mu,sa,ku,raa,na	मु,स,कु,रा,ना
ha,si,n	हँ,सि,याँ
dvaa,re	द्वा,रे
di,la,ru,baa	दि,ल,रु,बा
a,ka,don	आं,क,ड़ों
li,pa,te	लि,प,टें
chhu,pa,ne	छु,प,ने
chhu,pa,na	छु,प,ना
bi,kha,r,ne	बि,ख,र,ने
chhu,paa,n,gaa	छु,पा,ऊँ,गा
ha,ri,ya,na	ह,रि,या,णा
raa,jya	रा,ज्य
khe,luu	खे,लूँ
ja,ga,ma,gaa,o	ज,ग,म,गा,ओ
gu,n,gu,na,ye	गु,न,गु,ना,ए
fi,zaa,yon	फ़ि,ज़ा,ओं
pai,n	पै,याँ
pa,ha,chaa,n	प,ह,चा,न
da,ga,ma,gaa,ti	ड,ग,म,गा,ती
hai	है
ho	हो
u,pa,kaa,r	उ,प,का,र
sa,ng,raa,ma	स,न्ग,रा,म
pi,la,vaa,ye	पि,ल,वा,ए
na,zaa	ना,ज़ाँ
vi,dhaa,ya,ka	वि,धा,य,क
paa,n,gaa	पा,ऊँ,गा
daa,ya,re,cto	डा,य,रे,क्ट
du,ni,ya	दु,नि,या
ru,sa,vaa,yi	रु,स,वा,ई
aa,di,vaa,si	आ,दि,वा,सी
taa,ya,r	टा,य,र
u,da,ti	उ,ड़,ती
jhu,kaa,i,ye	झु,का,इ,ये
kha,da,ga,pu,r	ख,ड़,ग,पु,र
ye,sco,rt	ए,स्कॉ,र्ट
chhaa,yi	छा,ईं
ba,na,n,gi	ब,ना,ऊँ,गी
ba,na,yuu,gi	ब,ना,ऊं,गी
ba,saa,ye,nge	ब,सा,एं,गे
raa,shtra,ma,da,la	रा,ष्ट्र,मं,ड,ल
a,n,ba,n	अ,न,ब,न
sa,taa,ye	स,ता,एँ
aa,yi,kaa	आ,ई,का
ba,ta,laa,ye	ब,त,ला,ए
ba,ta,laa,ye	ब,त,ला,ये
raa,ste	रा,स्ते
i,ye,sa,aa,r,o	इ,ए,स,आ,र,ओ
ri,haa,yi	रि,हा,ई
khe,le,nge	खे,लें,गे
raa,ta,bha,r	रा,त,भ,र
ba,jaa,yi	ब,जा,ई
ba,jaa,o	ब,जा,ओ
su,la,ga,n	सु,ल,ग,न
suu,r,daa,sa	सू,र,दा,स
kaa,ta,ne	का,ट,ने
dau,da,taa	दौ,ड़,ता
vaa,lo	वा,लो
lu,taa,yuu	लु,टा,ऊं
ma,na,ye	म,ना,एँ
ma,da,bha,ri	म,द,भ,री
sa,ma,taa	स,म,झौ,ता
cha,dhaa,o	च,ढ़ा,ओ
u,tta,r,va,rdi	उ,त्त,र,व,र्दी
ta,n,haa,i,yon	त,न,हा,इ,यों
ja,n,taan,ntri,ka	ज,न,तां,त्रि,क
pra,shna	प्र,श्न
aa,za,maa	आ,ज़,मा
aa,za,maa	आ,ज़,मां
mu,la,ta	मू,ल,त,:
gaa,ye,nge	गा,यें,गे
gaa,ye,nge	गा,एं,गे
du,ri,yon	दू,रि,यों
sa,vaa,r,taa	सँ,वा,र,ता
ka,rma	क,र्म
aa,pa,ke	आ,प,के
ru,sa,vaa,i,yaan	रु,स,वा,इ,यां
sa,kri,ya	सं,क्रि,या
zi,da,gi	ज़िं,द,गी
ka,ha,ti	क,ह,ती
fa,r,maa,ya	फ,र,मा,या
aa,ye	आ,ए
aa,ye	आ,ये
au,r	औ,र
aa,vo	आ,वो
aa,o	आ,ओ
aa	आँ
aa,yi	आ,ईं
aa,ya	आ,य
ai,si	ऐ,सी
aa,ye	आ,ये
aa,yi	आ,यी
taa,ja,ma,ha,la	ता,ज,म,ह,ल
taa,za,ma,ha,la	ता,ज़,म,ह,ल
aa,uu	आ,ऊ
a,aa,pa	अ,आ,प
aa	आ
bu,jha,ne	बु,झ,ने
da,r,te	ड,र,ते
da,r,taa	ड,र,ता
da,r,ti	ड,र,ती
pa,ha,re	प,ह,रे
shaa,da,maa,ni	शा,द,मा,नी
khu,sha,nsi,bi,n	खु,श,न्सी,बि,याँ
ha,ma,raa,hi	ह,म,रा,ही
ba,dha,ka,r	ब,ढ़,क,र
bi,chha,de,nge	बि,छ,ड़ें,गे
chuu,moo	चू,मूँ
jhuu,ma,taa	झू,म,ता
jhuu,ma,ti	झू,म,ती
n,r,si,ha,ga,dha	न,र,सिं,ह,ग,ढ़
qa,ta,raa	क़,त,रा
ka,ta,re	क,त,रे
vi,raa	वी,राँ
re,ji,me,ta	रे,जि,में,ट
shi,ksha,ka	शि,क्ष,क
tu,jha,ko	तु,झ,को
bhu,la,ne	भू,ल,ने
aa,n,gaa	आ,ऊँ,गा
aa,yuu,gaa	आ,ऊं,गा
jo,da,na	जो,ड़,ना
r,ta,laa,ma	र,त,ला,म
saa,yi	सा,ईं
zu,baa	ज़ु,बाँ
sa,chchaa,yi	स,च्चा,ई
pa,r,chhaa,yi	प,र,छा,ई
ha,lka	ह,ल्का
ta,da,paa,taa	त,ड़,पा,ता
ta,da,paa,te	त,ड़,पा,ते
yu,vaa,yon	यु,वा,ओं
ru,ka,ti	रु,क,ति
ru,ka,tin	रु,क,तीं
ru,ka,ti	रु,क,ती
maa,n,na	मा,न,ना
o,stra,li,ya	ऑ,स्ट्रे,लि,या
bi,ye,cha,yu,vi,ja,n,n	बी,ए,च,यू, ,वि,ज,न,न
a,n,ka,hi	अ,न,क,ही
ka,ha,taa	क,ह,ता
ru,ka,vaa	रु,क,वा
ju,la,ne	जु,ल,ने
ju,la,na	जु,ल,ना
na,ri,n	ना,रि,याँ
kaa,vya	का,व्य
bu,raa,yi	बु,रा,ई
pa,ha,lo,o	प,ह,लो,ओ
ha,ma,re	ह,म,रे
ha,ma,raa	ह,म,रा
ha,ma,ri	ह,म,री
u,lle,kha,ni,ya	उ,ल्ले,ख,नी,य
jaa,ye,gaa	जा,ए,गा
ta,r,saa,ya	त,र,सा,या
ta,r,saa,ye	त,र,सा,ए
ta,r,saa,ye	त,र,सा,ये
do,luu	डो,लूँ
sa,ma,jhaa,n	स,म,झा,ऊँ
ta,ka,raa,yi	ट,क,रा,ई
ta,ka,raa,ye	ट,क,रा,ये
ta,ka,raa,ye	ट,क,रा,ए
chho,da,ke	छो,ड़,के
pa,la,ke	प,ल,कें
u	उँ
u,yi	उ,ई
di,khaa,i,ye	दि,खा,इ,ये
r,sa,va,ti	र,स,वं,ती
mu,jha,ko	मु,झ,को
bhaa,jaa,paa,yi	भा,जा,पा,ई
ba,ha,taa	ब,ह,ता
ba,ha,tein	ब,ह,तें
ba,ha,te	ब,ह,ते
ba,ha,ti	ब,ह,ती
ki,r,daa,r	कि,र,दा,र
chi,nh	चि,न्ह
gu,la,faa,ma	गु,ल,फ़ा,म
lu,taa,n,gi	लु,टा,ऊँ,गी
bi,ja,li	बि,ज,ली
bhaa,ye	भा,ए
ha,ma,n,vaa	ह,म,न,वा
bhaa,yi	भा,ई
haa	हाँ
pa,r,chhaa,yi,yaan	प,र,छा,ई,यां
dha,rma,vi,r	ध,र्म,वी,र
pa,ndra,ha	पं,द्र,ह
n,fa,r,ta	न,फ़,र,त
ba,taa,li,ya,n	ब,टा,लि,य,न
da,r,mi,n	द,र,मि,याँ
da,rmi,yaan	द,र्मि,यां
da,r	द,र,म्यां
ha,sa,r,ta	ह,स,र,त
ka,sa,maa,nu	क,स,मा,नु
r,ti,n	र,ति,याँ
ba,da,laa,von	ब,द,ला,वों
ni,baa,hoo,gaa	नि,बा,हूँ,गा
di,la,daa,raa	दि,ल,दा,रा
chaa,da	चाँ,द
ri,khshaa	रि,क्शा
vri,ksho	वृ,क्षों
thu,ma,kaa	ठु,म,का
r,he	र,हे
a,r,maa,no	अ,र,मा,नो
a,rmaa,non	अ,र्मा,नों
r,he	र,हें
vi,raa,ni,n	वी,रा,नि,याँ
n,cha,vaa,yi	न,च,वा,ई
vi,chaa,r,de	वि,चा,र,दे
i,ka,raa,r	इ,क,रा,र
i,qa,raa,r	इ,क़,रा,र
chha,tti,sa,ga,dha	छ,त्ती,स,ग,ढ़
de,kha,taa	दे,ख,ता
de,kha,te	दे,ख,ते
de,kha,ti	दे,ख,ती
de,kha,tin	दे,ख,तीं
ka,ja,raa	क,ज,रा
mu,ja,ri,ma	मु,ज,रि,म
da,vaa,yon	द,वा,ओं
so,cha,na	सो,च,ना
so,cha,ne	सो,च,ने
ye,va	ए,वं
sa,n,th,n,ga,r	स,न,थ,न,ग,र
sa,bha,la,na	सं,भ,ल,ना
aa,saa,yon	आ,सा,ओं
i,la,zaa,ma	इ,ल,ज़ा,म
ja,nmon	ज,न्मों
da,ga,ma,gaa,ne	ड,ग,म,गा,ने
u,la,jhe	उ,ल,झे
u,la,jhaa	उ,ल,झा
chha,li,ya	छ,लि,या
u,la,jhi	उ,ल,झी
ti,jo,ri,n	ति,जो,रि,याँ
to,ka,na	टो,क,ना
ba,ha,ka,ne	ब,ह,क,ने
ba,ha,ka,na	ब,ह,क,ना
zi,nda,gaa,ni	ज़ि,न्द,गा,नी
zi,da,gaa,ni	ज़िं,द,गा,नी
ma,da,ho,shi,yon	म,द,हो,शि,यों
sa,ja,na	स,ज,ना
pa,ta,ri	प,ट,री
pai,r,ha,n	पै,र,ह,न
i,sa,kaa	इ,स,का
ga,ma,gi,n	ग,म,गी,न
da,ba,la	ड,ब,ल
mu,kaa,ba,le	मु,का,ब,ले
ja,n,sa,khya	ज,न,सं,ख्या
u,ta,r,te	उ,त,र,ते
du,aa,ye	दु,आ,एं
du,aa,ye	दु,आ,यें
sa,da,maa	स,द,मा
to,da,ne	तो,ड़,ने
ka,chchi,n	क,च्चि,यँ
gaa	गा,वूँ
so,cho	सो,चो
pa,hu,chaa,ye,gaa	प,हुँ,चा,ए,गा
dha,da,kaa,ya	ध,ड़,का,या
va,la,haa,ya	व,ल,हा,या
ka,haa,ni,n	क,हा,नि,याँ
i,ta,raa,na	इ,त,रा,ना
ja,la,ta,ra,ga	ज,ल,त,रं,ग
de,khi,ye	दे,खि,ए
si,sa,ka,te	सि,स,क,ते
me,ri	मे,री
ba,noo	ब,नूँ
be,va,faa,yon	बे,व,फ़ा,ओं
cha,tu,raa,yi	च,तु,रा,ई
sa,pa,ne	स,प,ने
sa,pa,ne	स,प,नें
sa,pa,na	स,प,ना
sa,pa,no	स,प,नो
sa,pa,non	स,प,नों
gu,n,gu,na,te	गु,न,गु,ना,ते
gu,n,gu,na,ti	गु,न,गु,ना,ती
cha,ka,raa,ye	च,क,रा,ये
du,la,ha,n	दु,ल,ह,न
bhaa,ki,yu,ye	भा,कि,यू, ,ए
mu,sa,la,maa,n	मु,स,ल,मा,न
pi,taa	पि,ता
ka,sa,mon	क,स,मों
so,ha,ne	सो,ह,ने
so,ha,na	सो,ह,ना
so,ha,ni	सो,ह,णी
so,ha,ni	सो,ह,नी
be,ti,n	बे,टि,याँ
pi,laa,yi	पि,ला,ई
u,doo	उ,ड़ूँ
ja,la,pa,ri,n	ज,ल,प,रि,याँ
i,n,pe	इ,न,पे
ta,nhaa,i,yon	त,न्हा,इ,यों
ba,r,saa,ya	ब,र,सा,या
ba,r,saa,ye	ब,र,सा,ए
ba,r,saa,ye	ब,र,सा,ये
che,ha,ron	चे,ह,रों
ka,ta,raa	क,त,रा
sa,taa,o	स,ता,ओ
aa,r,i,si	आ,र, ,इ, ,सी
sa,taa,ye	स,ता,ए
ha,ma,raa,ha	ह,म,रा,ह
ka,bhi,ka,bhi	क,भी, ,क,भी
khu,shi	खु,शी
jhu,ka,ti	झु,क,ती
jhu,ka,ti	झु,क,ति
bhaa,r,ta	भा,र,त,‘
jhu,ka,taa	झु,क,ता
ha,ju,aa	हं,जु,आँ
pa,r,vaa,ne	प,र,वा,ने
pa,r,vaa,na	प,र,वा,ना
sa,ma,jhaa,n	स,म,झा,ऊँ
ma,ha,kaa,yuu	म,ह,का,ऊं
ro,ye,nge	रो,एँ,गे
ro,ye,nge	रो,एं,गे
va,haa	व,हाँ
ga,rd,n	ग,र्द,न
baa,rg,li	बा,र्ग,ली
do,ha,raa,ye	दो,ह,रा,ये
a,ha,ma,daa,baa,da	अ,ह,म,दा,बा,द
bi,di,ya	बिं,दि,या
chho,da,te	छो,ड़,ते
ha,sa,taa	हँ,स,ता
ha,sa,te	हँ,स,ते
ha,sa,te	ह,स,ते
ha,sa,ti	हँ,स,ती
sa,taa,yuu,gi	स,ता,ऊं,गी
bha,da,ka,ne	भ,ड़,क,ने
ga,n,taan,ntri,ka	ग,ण,तां,त्रि,क
ra,gi,n	रं,गी,न
ba,n,da	ब,न,द
u,lf,ta	उ,ल्फ़,त
ba,na,ya	ब,ना,या
ga,re,baa	ग,रे,बाँ
sha,r,maa,na	श,र,मा,ना
sai,n	सैं,याँ
la,gaa,n	ल,गा,ऊँ
pa,ta,ri	प,ट,री
ti,ta,li,yon	ति,त,लि,यों
u,taa,r,ke	उ,ता,र,के
di,khaa,n,gaa	दि,खा,ऊँ,गा
swa,pa,ni,la	स्व,प,नि,ल
ma,jha,dhaa,r	म,झ,धा,र
pa,ka,da,na	प,क,ड़,ना
pa,r,chhaa,i,n	प,र,छा,इं,याँ
bha,da,kaa,ti	भ,ड़,का,ती
ji,ga,la	जिं,ग,ल
ja,haa	ज,हाँ
raa,ja,dhaa,ni	रा,ज,धा,नी
khe,la,na	खे,ल,ना
ka,khe,la,na	क,खे,ल,ना
khe,la,ne	खे,ल,ने
u,la,jha,non	उ,ल,झ,नों
ha,ma,da,ma	ह,म,द,म
ma,ha,di	म,हं,दी
me,ha,di	मे,हं,दी
me,ha,ndi	मे,ह,न्दी
sa,taa,n	सं,ता,न
kaa,r,vaan	का,र,वां
i,ta,jaa,r	इं,त,जा,र
i,nta,zaa,r	इ,न्त,ज़ा,र
jaa,n,gi	जा,ऊँ,गी
jaa,yuu,gi	जा,ऊं,गी
jaa,yuu,gaa	जा,ऊं,गा
jaa,n,gaa	जा,ऊँ,गा
di,shaa	दि,शा
vaa,hi,ni	वा,हि,नी
gu,ja,raa,ta	गु,ज,रा,त
ni,gaa,raa	नि,गा,राँ
ma,na,luu	म,ना,लूँ
aa,yi	आ,ईं
lai,la,haa,ye	लै,ल,हा,ए
ru,n,jhu,n,ti	रु,न,झु,न,ती
cha,luu	च,लूँ
li,thi,ya,ma	लि,थि,य,म
ma,ha,lon	म,ह,लों
a,n,ka,hi	अ,न,क,ही
jaa,u,gi	जा,उँ,गी
ye,ha,saa	ए,ह,साँ
jaa,n,gaa	जा,ऊँ,गा
laa,bha,kaa,ri	ला,भ,का,री
mi,ta,raan	मि,त,रां
ba,ha,ka,ne	ब,ह,क,ने
ba,ha,ka,na	ब,ह,क,ना
shu,ka,ri,ya	शु,क,रि,या
ghoo,ma,taa	घू,म,ता
ghoo,ma,te	घू,म,ते
i,n,saa,non	इ,न,सा,नों
n,di,n	न,दि,याँ
n,di,ya	न,दि,या
aa,r,zu	आ,र,ज़ू
vaa	वा
so,ga,vaa,r	सो,ग,वा,र
bhu,ga,taa,n	भु,ग,ता,न
ga,ha,na	ग,ह,ना
khu,la,ne	खु,ल,ने
ja,n,ja,n	ज,न, ,ज,न
kaa,rya,shai,li	का,र्य,शै,ली
pa,r,maa	प,र,मा,णु
ta,sa,vi,ren	त,स,वी,रें
ba,la,khaa,ye	ब,ल,खा,ए
be,i,ya,r	बे,इ,ख़्थि,या,र
ma,ha,ke	म,ह,कें
a,fa,saa,ne	अ,फ़,सा,ने
a,va,sa,ron	अ,व,स,रों
mu,sa,li,ma	मु,स,लि,म
	c,a,n,n,o,t, ,u,n,d,e,r,s,t,a,n,d
pa,ni,haa,ri,n	प,नि,हा,रि,याँ
ji,se	जि,से
di,khaa,yi	दि,खा,ई
lau,ta,ka,r	लौ,ट,क,र
u,bha,raa	उ,भ,रा
pai,ru	पै,रूँ
gai,r	गै,र
cha,luu	च,लूँ
ru,laa,te	रु,ला,ते
su,n,ti	सु,न,ती
su,n,taa	सु,न,ता
aa,pa,ke	आ,प,के
va,faa,yon	व,फ़ा,ओं
va,faa,yon	व,फा,ओं
aa,pa,ko	आ,प,को
aa,pa,ki	आ,प,की
ka,ha,raa,hi	क,ह,रा,हि
u,bha,r,te	उ,भ,र,ते
u,bha,r,taa	उ,भ,र,ता
ta,da,paa,ye,gaa	त,ड़,पा,ए,गा
be,ha,ta,r	बे,ह,त,र
ga,laa	ग,लाँ
ja,n,va,ri	ज,न,व,री
ki,sa,daa	कि,स,दा
thu,ka,raa	ठु,क,रा
hi,la,ne	हि,ल,ने
pa,ta,jha,da	प,त,झ,ड़
u,n,n	उ,न,वाँ
ba,rf	ब,र्फ़
da,r,vaa,je	द,र,वा,जे
sa,da,bu,ddh	स,द,बु,द्ध
ki,ta,ni	कि,त,नी
ki,ta,non	कि,त,नों
ki,ta,no	कि,त,नो
ki,ta,na	कि,त,ना
ki,ta,na	कि,त,ना
ki,ta,ne	कि,त,ने
ki,ta,ni	कि,त,नी
dhaa,ha,ni	ढा,ह,नी
ba,dha,taa	ब,ढ़,ता
ba,dha,te	ब,ढ़,ते
ba,dha,ti	ब,ढ़,ती
ma,cha,la,na	म,च,ल,ना
kyaa,lon	ख़्या,लों
khya,lon	ख्या,लों
ju,baa	जु,बाँ
n,ga,maa,ga,r	न,ग़,मा,ग,र
cha,n,sa,ma	च,न,स,म
maa,r,ne	मा,र,ने
koo,daa,yi	ख़ू,दा,ई
khu,daa,yi	खु,दा,ई
ku,daa,yi	ख़ु,दा,ई
ghu,la,ne	घु,ल,ने
mo,ma,ba,tti	मो,म,ब,त्ती
da,ga,ma,gaa,ye	ड,ग,म,गा,ए
sa,daa,ye	स,दा,एं
chhaa,n,gi	छा,ऊँ,गी
ja,gaa,yi	ज,गा,ई
ja,gaa,o	ज,गा,ओ
ba,r,baa,di	ब,र,बा,दी
bhi,ta,r	भी,त,र
bhi,ta,r	भी,त,र
ta,da,pa,ne	त,ड़,प,ने
jaa,ne	जा,ने
ta,da,pa,na	त,ड़,प,ना
ka,r,n	क,र,वाँ
sa,ka,lai,n	स,क,लै,न
di,shaa,yon	दि,शा,ओं
kaa,haa	का,हाँ
sa,khi,n	स,खि,याँ
saa,thi,ya	सा,थि,या
u,da,taa	उ,ड़,ता
u,da,te	उ,ड़,ते
sa,ha,ti	स,ह,ती
vaa,di,n	वा,दि,याँ
do,sau,sau,5,sau,6	2,0,0,5, ,0,6
bi,ye,cha,yu,vi,ja,na,ni	बी,ए,च,यू, ,वि,ज,ना,नी
r,ha,taa	र,ह,ता
na,ga,pu,r	ना,ग,पु,र
si,khaa,o,nge	सि,खा,ओ,गे
ta,r,saa	त,र,सा
ta,r,se	त,र,से
ta,r,si	त,र,सी
ma,ja,boo,r	म,ज,बू,र
sa,ka,la,n	सं,क,ल,न
vi,raa	वी,राँ
sha,ha,baa,za	श,ह,बा,ज़
ja,nge	ज,गे
la,la,chaa,ye	ल,ल,चा,एं
ta,ga,di	त,ग,ड़ी
ta,ga,daa	त,ग,ड़ा
bi,ta,te	बी,त,ते
lo,yi	लो,ई
va,khi,n	व,खि,याँ
bhaa,yi,yon	भा,ई,यों
bi,r,ha,n	बि,र,ह,न
bi,rhaa	बि,र्हा
bi,r,haa	बि,र,हा
la,ha,raa,yi	ल,ह,रा,ई
ha,ma,za,baa	ह,म,ज़,बाँ
aa,ke	:,आ,के,:
ye,ye,ke,je	ए,ए,के,जे
baa,rg,li	बा,र्ग,ली
su,na,yuu	सु,ना,ऊं
mu,sku,raa,ye,nge	मु,स्कु,रा,एं,गे
frie,ka,ste,n	फ्रें,क,स्टी,न
di,la,ja,le	दि,ल,ज,ले
i,sa,me	इ,स,में
cha,dhaa,yi	च,ढ़ा,ई
cha,dhaa,o	च,ढ़ा,ओ
vya,va,saa,ya	व्य,व,सा,य
i,ta,vaa,r	इ,त,वा,र
ja,la,ti	ज,ल,ती
pa,ra,tu	प,रं,तु
ha,ma,saa,ye	ह,म,सा,ए
pi,ha,r,vaa	पि,ह,र,वा
pyaa,laa	प्या,ला
i,ta,raa,i,ye	इ,त,रा,इ,ये
bhaa,r,ti,ya	भा,र,ती,य
chu,raa,yuu,di	चु,रा,ऊं,दी
maa,n,taa,ye	मा,न,ता,एँ
khaa,yi	खा,ई
fa,ri,ya,da	फ़,रि,या,द
aa,o,nge	आ,ओ,गे
aa,o,gi	आ,ओ,गी
kaa	का
su,koo	सु,कूँ
kvaa,ba	ख़्वा,ब
khwaa,ba	ख्वा,ब
ta,qa,di,ron	त,क़,दी,रों
sha,ha,na,i,yon	श,ह,ना,इ,यों
gu,maa	गु,माँ
gu,maa	ग़ु,माँ
ba,n,ke	ब,न,के
so,choo	सो,चूँ
ja,gaa,ye	ज,गा,ए
thu,ka,raa,ye	ठु,क,रा,ये
thu,ka,raa,ya	ठु,क,रा,या
so,o,r	सो,ओ,र
ku,sha,haa,la	ख़ु,श,हा,ल
ba,sti,n	ब,स्ति,याँ
kri,yaan,va,ya,n	क्रि,यां,व,य,न
ya,da	या,द
ya,ha	य,ह
spa,ne	स्प,ने
kri,ti	कृ,ति
ka,r,ti	क,र,ती
aa,i,ye,fa,ye,fa	आ,इ,ए,फ,ए,फ
su,ne,ha,re	सु,ने,ह,रे
su,n,ha,re	सु,न,ह,रे
su,ne,ha,raa	सु,ने,ह,रा
su,n,ha,raa	सु,न,ह,रा
ba,cha,pa,n	ब,च,प,न
khi,la,ne	खि,ल,ने
khi,la,na	खि,ल,ना
te,ye,sa,ri	ते,ए,स,रि
taa,ro	ता,रो
be,va,faa,yi	बे,व,फ़ा,ई
ba,taa,ye	ब,ता,एँ
nyu,n,ta,ma	न्यू,न,त,म
chhu,n,mu,n	छु,न,मु,न
ka,rma,chaa,ri,yon	क,र्म,चा,रि,यों
jaa,i,ye	जा,इ,ये
sa,va,r,na	सं,व,र,ना
sa,va,r,ne	सं,व,र,ने
i,khti,ya,r	इ,ख़्ति,या,र
jha,n,kaa,r	झ,न,का,र
she,r,ni	शे,र,नी
ma,da,ho,shi,yo,me	म,द,हो,शि,यो,मे
kaa	का
ja,ni,n	ज,नि,याँ
ka,yi	क,ई
kaa	का
kaa	का
kaa	का
kaa	का
kaa	का
kaa	का
ki	की
lu,taa,ye	लु,टा,ए
lu,taa,yi	लु,टा,ई
lu,taa,o	लु,टा,ओ
u,pa,ka,r,n	उ,प,क,र,ण
sa,ma,jhaa,o	स,म,झा,ओ
qi,sa,ma,ta	क़ि,स,म,त
u,pa,ka,r,n	उ,प,क,र,ण
chu,bha,te	चु,भ,ते
ma,chaa,n,gi	म,चा,ऊँ,गी
ba,taa,ye	ब,ता,ए
i,n,kaa,r	इ,न,का,र
ba,cha,pa,n	ब,च,प,न
i,n,kaa	इ,न,का
si,r,da,rd	सि,र,द,र्द
la,ha,raa,ti	ल,ह,रा,ती
dhu,n	धु,वाँ
la,ha,ri	ल,ह,री
maa,ma,laa	मा,म,ला
maa,ma,lon	मा,म,लों
la,ha,raa	ल,ह,रा
r,sa,me	र,स,में
ta,pa,ki	ट,प,की
mu,ska,raa,o	मु,स्क,रा,ओ
pra,do	प्र,दो
luu	लूँ
baa,ri,ki,n	बा,री,कि,याँ
va,n,se,vaa	व,न,से,वा
bi,ka,te	बि,क,ते
ta,pa,ke	ट,प,के
bi,ka,taa	बि,क,ता
bi,ka,ti	बि,क,ती
jhu,ka,ne	झु,क,ने
smaa,r,ka	स्मा,र,क
sa,chchaa,yi	स,च्चा,ई
ma,sa,la,ne	म,स,ल,ने
su	सु,क़ूँ
sa,ha,mi	स,ह,मी
sa,ha,me	स,ह,मे
lu,ta,ne	लु,ट,ने
pa,r,daa,daa	प,र,दा,दा
hi,ro,i	हि,रो,इ,न्
ta,sa,vi,ren	त,स,वी,रें
baa,ye	बा,एं
ti,mi,r,va,r,n	ति,मि,र, ,व,र,ण
te,re	ते,रे
i,za,haa,r	इ,ज़,हा,र
ka,ha,laa,ye,gaa	क,ह,ला,ए,गा
ja,nmaa	ज,न्मा
ka,yi	क,ई
ghe,r,ti	घे,र,ती
haa,re	हा,रे
ha,re	ह,रे
ka,ha,laa,te	क,ह,ला,ते
ka,ha,laa,taa	क,ह,ला,ता
saa,va,ri,n	सा,व,रि,याँ
di,la,vaa,li	दि,ल,वा,ली
di,la,vaa,le	दि,ल,वा,ले
di,la,vaa,laa	दि,ल,वा,ला
ti,ta,li,n	ति,त,लि,याँ
pa,la,ti	प,ल,ती
pa,la,te	प,ल,ते
kyo	क्यूँ
vaa,li,n	वा,लि,याँ
ja,ma,ke	ज,म,के
ji,ta,na	जि,त,ना
sa,ma,jha,na	स,म,झ,ना
ba,ta,laa,o	ब,त,ला,ओ
gu,ja,raa,ti	गु,ज,रा,ती
jaa,ga,taa	जा,ग,ता
jaa,ga,te	जा,ग,ते
jaa,ga,ti	जा,ग,ती
dau,raa	दौ,राँ
ta,pa,te	त,प,ते
maa,ru	मा,रूँ
ro,sha,na,yi	रो,श,ना,ई
ha,vaa,ye	ह,वा,एँ
ba,ta,laa,do	ब,त,ला,दो
pa,kaa,ye	प,का,एं
be,i,maa	बे,इ,मां
be,i,maa,n	बे,इ,मा,न
ta,ka,di,r	त,क,दी,र
baa,zu,yon	बा,ज़ु,ओं
baa,ju,yon	बा,जु,ओं
chaa,hoo	चा,हूँ
fa,r,haa,da	फ़,र,हा,द
fa,r,haa,da	फ,र,हा,द
pa,hu,cha,na	प,हुँ,च,ना
ri,sa,ne	रि,स,ने
pa,hu,cha,ne	प,हुँ,च,ने
bi,ga,da,ti	बि,ग,ड़,ती
ta,da,pa,ti	त,ड़,प,ती
paa,sa,baa	पा,स,बाँ
du,aa,ye	दु,आ,यें
ja,la,ne,vaa,laa	ज,ल,ने,वा,ला
a,ga,daa,i,n	अं,ग,ड़ा,इ,याँ
jaa,ye	जा,एँ
gaa,i,ga	गा,इं,ग
du,khaa,o	दु,खा,ओ
ha,r,jaa,yi	ह,र,जा,ई
ha,rja,yi	ह,र्जा,ई
faa,ya,daa	फ़ा,य,दा
faa,ya,daa	फा,य,दा
ji,sa,me	जि,स,मे
ji,sa,me	जि,स,में
1,do	1,9,8,2
na,pa,gu,a,la	ना,प,गु,अ,ल
ja,ma,ka,r	ज,म,क,र
to,da,ka,r	तो,ड़,क,र
mu,skaa,o	मु,स्का,ओ
raa,jya	रा,ज्य
ja,la,vaa	ज,ल,वा
ja,la,ve	ज,ल,वे
pa,ha,chaa,n,na	प,ह,चा,न,ना
ha,vaa,ye	ह,वा,एं
da,r,vaa,je	द,र,वा,जे
da,r,vaa,zaa	द,र,वा,ज़ा
da,r,vaa,je	द,र,वा,जे
pa,ka,do,nge	प,क,ड़ो,गे
ta,da,paa,ye,nge	त,ड़,पा,एं,गे
pa,r,maa	प,र,मा,णु
pa,r,maa	प,र,मा,णु
r,sa,ma	र,स,म
khwaa,ba	ख्वा,ब
kvaa,bon	ख़्वा,बों
to,doo	तो,ड़ूँ
raa,ja,ni,ti,ka	रा,ज,नी,ति,क
dha,r,ti	ध,र,ती
ta,da,paa,o	त,ड़,पा,ओ
r,ha,jaa,n,gaa	र,ह,जा,ऊँ,गा
mu,sa,kaa,n	मु,स,का,ऊँ
ve,da,na	वे,द,ना
la,ha,ren	ल,ह,रें
bi,chhaa,ye,nge	बि,छा,एं,गे
ya	या
ya,yi	या,ई
ya	या
du,aa,n	दु,आ,ओँ
du,aa,yon	दु,आ,ओं
ro,ye	रो,एँ
ma,rda,n,gi	म,र्दा,न,गी
',che,'	’,चे,’
ku,ja,n	कुं,ज,न
a,ha,ma,da	अ,ह,म,द
sa,tu,la,n	सं,तु,ल,न
ja,n	ज,वाँ
jaa,n	जा,न
ta,n,haa,yi	त,न,हा,ई
ta,nhaa,yi	त,न्हा,ई
ta,n,haa	त,न,हा
do,sau,sau	2,0,0
a,pa,raa,ndhi	अ,प,रा,धी
la,da,taa	ल,ड़,ता
paa,n,gi	पा,ऊँ,गी
mi,ta,raa	मि,त,रा
mu,skaa,ye,gaa	मु,स्का,ए,गा
ma,cha,le,gaa	म,च,ले,गा
la,nge	ल,गे
the	थे
n,za,ren	न,ज़,रें
ba,haa,o,nge	ब,हा,ओ,गे
sa,pa,non	स,प,नों
mo,ha,ni	मो,ह,णी
mo,ha,ni	मो,ह,नी
ga,vaa,i	ग,वा,इ
ga,vaa,yi	ग,वा,ई
ga,n	ग,वाँ
ka,da,vaa	क,ड़,वा
r,hoo	र,हूँ
raa,hu	रा,हु
u,lle,kha,ni,ya	उ,ल्ले,ख,नी,य
chhu,paa,yi	छु,पा,ई
ba,bu,aa	ब,बु,आ
u,da,taa	उ,ड़,ता
pi,laa,yuu,gaa	पि,ला,ऊं,गा
mu,sa,kaa,yi	मु,स,का,ई
pu,kaa,ru	पु,का,रूँ
pa,r,don	प,र,दों
ba,sa,ka,r	ब,स,क,र
so,lha,n	सो,ल्ह,वाँ
se,vaa,ye	से,वा,एँ
pu,r,vaa,yi	पु,र,वा,ई
maa,goo	माँ,गूँ
ka,r,te	क,र,ते
ta,r,saa,o	त,र,सा,ओ
pa,ha,noo	प,ह,नूँ
ma,ha,lon	म,ह,लों
ka,nhaa,yi	क,न्हा,ई
ga,ha,raa,ya	ग,ह,रा,या
daa	दा,स्ताँ
mu,sku,raa,ye	मु,स्कु,रा,ये
la,ha,ki	ल,ह,की
pe,ha,chaa,na	पे,ह,चा,ना
pa,ha,chaa,na	प,ह,चा,ना
gu,jaa,i,sha	गुं,जा,इ,श
la,ma,ho	ल,म,हों
chu,noo	चु,नूँ
la,da,ka,ha,daa,te	ल,द,क,ह,दा,ते
du,aa,ye	दु,आ,एँ
gu,za,raa	गु,ज़,रा
gu,za,re	ग़ु,ज़,रे
gu,za,re	गु,ज़,रे
gu,za,ri	गु,ज़,री
cha,da,rbha,n	चं,द,र्भा,न
ta,da,paa,ye,gi	त,ड़,पा,एं,गी
gu,la,na,r	गु,ल,ना,र
aa,ta,maa	आ,त,मा
chha,le,nge	छ,लें,गे
lu,taa,ye	लु,टा,एं
mu,ga,le	मु,ग,ले
cha,n,ve	च,न,वे
ta,ma,nna,yon	त,म,न्ना,ओं
mu,aa,fa	मु,आ,फ़
ri,ma,jhi,ma	रि,म,झि,म
a,daa,yon	अ,दा,ओं
r,ha,maa,n	र,ह,मा,न
ku,daa,yi	ख़ु,दा,ई
mi,laa	मि,ला
mi,laa,o	मि,ला,ओ
mi,laa,yi	मि,ला,ई
fu,rsa,ta	फ़ु,र्स,त
mi,laa,ye	मि,ला,ए
cha,dha,ti	च,ढ़,ती
ha,la,cha,la	ह,ल,च,ल
khaa,ye,gaa	खा,ए,गा
sa,mbha,la,taa	स,म्भ,ल,ता
ho,li,da	हॉ,लि,वु,ड
ga,ya	ग,या
ta,r,faa	त,र,फ़ा
dha,taa	ढ़ूँ,ढ़,ता
i,mti,haa	इ,म्त,हाँ
da,r,ti	ड,र,ती
da,r,te	ड,र,ते
da,r,taa	ड,र,ता
va,kt,vya	व,क्त,व्य
do,o	दो,ओ
ye,ma	ए,म
baa,ji,n	बा,जि,याँ
ba,ha,laa,n	ब,ह,ला,ऊँ
mu,sku,raa,ye,gaa	मु,स्कु,रा,ए,गा
fa,r,maa,i,ye	फ़,र,मा,इ,ये
thu,ka,raa,o	ठु,क,रा,ओ
ja,nge	ज,गे
jaa,ne	जा,ने
laa,yi	ला,ई
bi,chhaa,ye	बि,छा,एं
jaa,ne,jaa	जा,ने,जाँ
vaa,di,ya	वा,डि,या
khu,sha,n,si,ba	खु,श,न,सी,ब
fa,r,maa,i,sha	फ़,र,मा,इ,श
va,faa,ye	व,फ़ा,एं
se,vaa,ye	से,वा,एँ
phu,la,vaa,ri	फु,ल,वा,री
chaa,he	चा,हे
mu,aa,ma,le	मु,आ,म,ले
n,vi	न,वीं
da,ha,laa	द,ह,ला
gha,ba,raa	घ,ब,रा
la,ga,bha,ga	ल,ग,भ,ग
la,la,chaa,n,gaa	ल,ल,चा,ऊँ,गा
chhu,aa	छु,आ
choo	चूँ
gu,la,zaa,r	गु,ल,ज़ा,र
bha,r	भ,र
ga,ma,ry	ग,म,र्
ka,hi,ye	क,हि,ए
ki	की
ki,ye	कि,ए
sa,jaa,n,gaa	स,जा,ऊँ,गा
se,vaa,yon	से,वा,ओं
ka,ba,se	क,ब,से
su,kha,ry	सु,ख,र्
kho,la,ti	खो,ल,ति
kho,la,ti	खो,ल,ती
kho,la,taa	खो,ल,ता
la,gaa,i,ye	ल,गा,इ,ये
kho,li,yo	खो,लि,यो
sha,r,don	श,र,दों
la,ha,zaa	ल,ह,ज़ा
laa,n,gaa	ला,ऊँ,गा
do,sau,sau	2,0,0
pu,r,vaa	पु,र,वा
la,di,n	ल,ड़ि,याँ
la,di,n	ल,डि,याँ
gha,ba,raa,i,ye	घ,ब,रा,इ,ये
bha,r,taa	भ,र,ता
bha,r,te	भ,र,ते
bha,r,ti	भ,र,ती
bhaa,r,ti	भा,र,ती
gha,taa,ye	घ,टा,एं
vi,shva,na,th,n	वि,श्व,ना,थ,न
chhi,paa,ye	छि,पा,ए
chhi,paa,o	छि,पा,ओ
ha,sa,r,ta	ह,स,र,त
cha,ha,kaa	च,ह,का
ka,ta,raa	क,त,रा
ka,ta,raa	क,ट,रा
ja,vaa,ni,n	ज,वा,नि,याँ
ba,r,saa,ne	ब,र,सा,ने
do,ha,raa,te	दो,ह,रा,ते
kyaa	क्या
chhaa,yi	छा,ई
gha,ba,raa,o	घ,ब,रा,ओ
ta,ka,raa,ye,gi	ट,क,रा,ए,गी
aa,dhaa,r,sa,r,cha,na,yon	आ,धा,र,सं,र,च,ना,ओं
a,ha,ma,daa,baa,da	अ,ह,म,दा,बा,द
va,faa,yon	व,फ़ा,ओं
su,la,ngin	सु,ल,गीं
su,la,gi	सु,ल,गी
ha,ta,ke	ह,ट,के
si,laa,yi	सि,ला,ई
su,la,nge	सु,ल,गे
gu,n,gu,na,ye	गु,न,गु,ना,एं
gha,ta,na	घ,ट,ना
nyaa,ri	न्या,री
la,da,kha,daa,taa	ल,ड़,ख,ड़ा,ता
pa,n,va,di,ya	प,न,व,ड़ि,या
tu,ma,kaa,o	तु,म,का,ओ
ga,yi,n	ग,ई,याँ
tu,ma,haa,ri	तु,म,हा,री
maa,ga,ne	माँ,ग,ने
ma,ga,ni	मं,ग,नी
shaa,ka,sa	शा,क,स
ba,ha,ke,gaa	ब,ह,के,गा
ha,sa,r,tein	ह,स,र,तें
ru,sa,vaa,yi,yaan	रु,स,वा,ई,यां
ru,sa,vaa,i,n	रु,स,वा,इ,याँ
ru,sa,vaa,i,yaan	रु,स,वा,इ,यां
ja,ga,lon	जं,ग,लों
mi,laa,o,nge	मि,ला,ओ,गे
ba,la,vaa	ब,ल,वा
r,ga,daa	र,ग,ड़ा
a,dhi,kaa,ri,yon	अ,धि,का,रि,यों
raa,ja,ni,ti,ka	रा,ज,नी,ति,क
gi,ri,n	गि,रि,याँ
gi,r,dhaa,ri	गि,र,धा,री
ka,ha,na	क,ह,ना
gu,la,zaa,ron	गु,ल,ज़ा,रों
sa,ha,re	स,ह,रे
se,ha,re	से,ह,रे
se,ha,raa	से,ह,रा
sa,ha,raa	स,ह,रा
sa,ha,ri	स,ह,री
ku,ma,ku,ma	कु,म,कु,म
mo,sko	मॉ,स्को
gaa,ye	गा,यें
1,sau	1,0
1,do	1,2
1	1,4
di,la,ke	दि,ल,के
1	1,8
ba,ha,laa,ye,gaa	ब,ह,ला,ए,गा
sha,raa,bi,n	श,रा,बि,याँ
su,la,jhaa,ya	सु,ल,झा,या
bi,kha,raa,ya	बि,ख,रा,या
bi,kha,raa,ye	बि,ख,रा,ये
va,haa	व,हाँ
mu,skaa,i,ye	मु,स्का,इ,ये
mu,sa,kaa,yi	मु,स,का,ई
pa,ka,de	प,क,डे
ja,laa,ya,le	ज,ला,य,ले
mu,sa,kaa,ye	मु,स,का,ये
ye,ha,saa,n	ए,ह,सा,न
raa,ja,dhaa,ni	रा,ज,धा,नी
ye,ha,saa,sa	ए,ह,सा,स
di,la,da,r	दि,ल,द,र
di,la,daa,r	दि,ल,दा,र
ka,haa,ni,n	क,हा,नि,याँ
bu,ne	बु,ने
aa,za,maa	आ,ज़,मां
chha,la,kaa	छ,ल,का
tu,ka,don	टु,क,ड़ों
maa,r,te	मा,र,ते
mu,r,jhaa	मु,र,झा
dhu,da,li	धुं,द,ली
ba,taa,n	ब,ता,ऊँ
cha,le	च,लें
su,na,u	सु,ना,उं
cha,le	च,ले
r,ha,gu,zaa,ron	र,ह,गु,ज़ा,रों
pa,r,chhaa,yi,n	प,र,छा,ई,याँ
bu,jhaa,ye	बु,झा,एँ
da,vaa,yi	द,वा,ई
ka,raa	क,राँ
ka,raa,o	क,रा,ओ
kaa	काँ
kaa	का
ve,li,ng,ta,ma	वे,लि,न्ग,ट,म
ve,li,ng,ta,n	वे,लि,न्ग,ट,न
pi,ho,o	पी,हो,ओ
ba,tti,n	ब,त्ति,याँ
ka,r,na	क,र,णा
ka,r,na	क,र,ना
a,dhi,ni,a,ya,ma	अ,धि,नि,अ,य,म
i,kaa,i,yon	इ,का,इ,यों
fa,r,maa,i,ye	फ़,र,मा,इ,ये
ja,ga,ma,gaa,ye,gi	ज,ग,म,गा,ए,गी
ta,da,paa,ya	त,ड़,पा,या
laa,gha,ne	लाँ,घ,ने
ta,da,paa,ye	त,ड़,पा,ए
ta,da,paa,ye	त,ड़,पा,एँ
gu,ja,n	गुं,ज,न
la,gaa,ye	ल,गा,एँ
ta,ka,raa,ye	ट,क,रा,एं
paa,ri,yon	पा,री,ओं
sa,tra,nyaa,ya,ndhi,sha	स,त्र,न्या,या,धी,श
u,taa,ru	उ,ता,रूँ
ga,la,ti,yon	ग,ल,ति,यों
saa,di,n	सा,ड़ि,याँ
ni,ka,la,ke	नि,क,ल,के
ba,r,saa,ye	ब,र,सा,ए
su,ba,ha	सु,ब,ह
ba,r,saa,o	ब,र,सा,ओ
su,ba,ha	सु,ब,ह
kha,r,ka,r,vaa,le	ख,र,क,र,वा,ले
sa,faa,yi	स,फा,ई
sa,faa,yi	स,फ़ा,ई
ma,hi,laa,yon	म,हि,ला,ओं
bai,tha,na	बै,ठ,ना
hu,sa,ke	हु,स,के
ta,n,daa,na	त,न,दा,ना
go	गो
sa,ma,jhaa,ye	स,म,झा,यें
sa,ma,pa,nna	स,म,प,न्न
sa,ha,vaa,ga	स,ह,वा,ग
si,da,baa,da	सिं,द,बा,द
pa,la,khi,n	प,ल,खि,याँ
u,chaa,yi	उँ,चा,ई
paa,ye,nge	पा,एं,गे
sa,r,ni,goo	स,र,नि,गूँ
pa,ba,li,ka	प,ब,लि,क
a,ja,hu	अ,ज,हुँ
r,ha,ka,r	र,ह,क,र
va,di,n	वं,दी,न
du,n,kaa	दु,न,का
phu,la,vaa,ri	फु,ल,वा,री
sa,shaa,sa,n	स,शा,स,न
cha,ka,raa,ye	च,क,रा,ए
cha,ka,raa,ye	च,क,रा,ये
ta,ka,ni,ka	त,क,नी,क
va,n,ro,pa,n	व,न,रो,प,ण
a,r,zi	अ,र,ज़ी
pa,doo	प,ड़ूँ
gi,ne	गि,ने
mi,sa,ri	मि,स,री
be,za,baa	बे,ज़,बाँ
ka,taa,yon	ख़,ता,ओं
sa,ja,de	स,ज,दे
do	2,4
do,6	2,6
do,sau	2,0
do,do	2,2
a,pa,na,ni	अ,प,ना,नी
do	2,8
do	2,9
pra,dhaa,n,ma,tri	प्र,धा,न,मं,त्री
pa,ha,na,yuu,gi	प,ह,ना,ऊं,गी
haa	हाँ
bhaa,i,yon	भा,इ,यों
a,njaa,ni	अ,न्जा,नी
pa,ha,lu	प,ह,लू
a,jaa,ne	अं,जा,ने
a,njaa,ne	अ,न्जा,ने
pa,ha,le	प,ह,ले
pa,ha,la	प,ह,ल
pa,ha,li	प,ह,ली
pa,ha,laa	प,ह,ला
ba,ka,pa,n	बं,क,प,न
pa,ha,chaa,n	प,ह,चा,न
a,l	अ,क्ल
chhe,da,ti	छे,ड़,ती
a,la,kon	अ,ल,कों
pa,r,daa,n,shi,non	प,र,दा,न,शी,नों
ba,ha,kaa	ब,ह,का
ki,r,non	कि,र,नों
ki,r,non	कि,र,णों
ro,ka,taa	रो,क,ता
nau,ja,vaa,no	नौ,ज,वा,नो
ba,n	ब,याँ
bai,r,ka,pu,r	बै,र,क,पु,र
la,ha,raa,ke	ल,ह,रा,के
cha,ma,ki	च,म,की
cha,ma,kaa	च,म,का
cha,ma,ke	च,म,के
pi,laa,n,gi	पि,ला,ऊँ,गी
r,chaa,yi	र,चा,ई
mi,li,ye,gaa	मि,लि,ए,गा
su,na,ye	सु,ना,एं
i,nte,haa	इ,न्ते,हाँ
aa,tha	आ,ठ
me	मे
me,n	में,न
mai	मै
me,i	मे,इं
me,i,n	मे,इ,न
ka,da,kaa	क,ड़,का
vaa,ste	वा,स्ते
ba,da,r,vaa	ब,द,र,वा
sa,hi	स,ही
bi,sa,raa	बि,स,रा
khe,luu	खे,लूँ
ndi,ti,ye,cha	डी,टी,ए,च
ba,da,laa,va	ब,द,ला,व
la,ma,haa	ल,म,हा
ba,da,laa	ब,द,ला
da,sa,ti	ड,स,ती
ta,la,vaa,r	त,ल,वा,र
ta,da,paa,o,nge	त,ड़,पा,ओ,गे
ba,dha,ke	ब,ढ़,के
bi,chha,da,ke	बि,छ,ड़,के
tu,ma,ri	तु,म,री
ru,pa,yon	रु,प,यों
ta,ma,nna,ye	त,म,न्ना,एँ
gaa	गा
gaa	गा
ga,yi	ग,ई
gha,di	घ,ड़ी
laa,yuu,gaa	ला,ऊं,गा
baa,re	बा,रे
ja,ga,ne	ज,ग,ने
pa,r,chhaa,i,n	प,र,छा,इ,याँ
pa,r,chhaa,yi,n	प,र,छा,ई,याँ
pa,r,chhaa,yi,yaan	प,र,छा,ई,यां
mu,jha,ko	मु,झ,को
u,thu	उ,ठूँ
ki,zaa	ख़ि,ज़ाँ
du,aa,ye	दु,आ,एँ
du,aa,ye	दु,आ,एं
thaa,ko,o,r	ठा,को,ओ,र
ru,ka,ma,ni	रु,क,म,नी
aa,ja,maa,na	आ,ज,मा,ना
aa,za,maa,ye	आ,ज़,मा,ये
aa,za,maa,ya	आ,ज़,मा,या
vaa,li,n	वा,लि,याँ
pa,hu,che	प,हुँ,चे
laa,za,mi	ला,ज़,मी
du,shma,na	दु,श्म,नाँ
a,cto,ba,r,1,5	अ,क्तू,ब,र, ,1,5
na,cho,n,gi	ना,चो,ओँ,गी
paa,n,gi	पा,ऊँ,गी
paa,yuu,gi	पा,ऊं,गी
nge,hoo	गे,हूँ
paa,n,gaa	पा,ऊँ,गा
ha,ma,sa,fa,r	ह,म,स,फ़,र
ju,noo	जु,नूँ
ju,no,o,n	जु,नो,ओ,न
pa,re,shaa,ni,n	प,रे,शा,नि,याँ
ka,haa	क,हाँ
ka,ha	क,हँ
ka,haa	क,हा
si,ga,la	सिं,ग,ल
ru,baa,yi	रु,बा,ई
le,luu	ले,लूँ
hi,cha,ko,le	हि,च,को,ले
gha,di,n	घ,ड़ि,याँ
ni,shaa,ni,n	नि,शा,नि,याँ
ja,za,bon	ज,ज़,बों
be,zu,baa	बे,ज़ु,बाँ
me,ha,taa	मे,ह,ता
chuu,moo	चू,मूँ
vi,chaa,r,kon	वि,चा,र,कों
phu,aa,r	फु,आ,र
phu,la,vaa,ri,n	फु,ल,वा,रि,याँ
du,sha,vaa,r	दु,श,वा,र
ga,r,ma	ग,र,म
ba,chaa,i,ye	ब,चा,इ,ये
r,kha,ke	र,ख,के
pa,r,kha,na	प,र,ख,ना
laa,va,ni	ला,व,णी
ya,da	या,द
ni,haa	नि,हा
ti,sa	ती,स, ,n,u,m
3,sau	3,0
3,5	3,5
ni,haa	नि,हाँ
ja,gaa,ye,gi	ज,गा,ए,गी
r,sa,ma,laa,yi	र,स,म,ला,ई
jaa,n	जा,न
ja,haa	ज,हा
ja,haa	ज,हाँ
aa,i,aa,i,ti	आ,इ,आ,इ,टी
mu,sku,raa,ye	मु,स्कु,रा,एं
ma,sa,taa,na	म,स,ता,ना
mu,ja,taa,r	मु,ज,ता,र
aa,yi,aa,yi,ye,ma	आ,ई,आ,ई,ए,म
ye,fa	ए,फ़
sa,ga,tha,n	सं,ग,ठ,न
chu,raa,ye	चु,रा,एँ
pa,te,ri,ya	प,टे,रि,या
pa,r,vaa,ha	प,र,वा,ह
vaa,laa	वा,ला
bi,chha,da,ne	बि,छ,ड़,ने
kha,ya,la	ख,या,ल
u,n,ko,o	उ,न,को,ओ
i,n,se	इ,न,से
ba,haa,ye	ब,हा,एँ
da,r,vaa,je	द,र,वा,जे
ka,ma,re	क,म,रे
u,ga,li,n	उं,ग,लि,याँ
chu,pa,ke	चु,प,के
chhu,pa,ke	छु,प,के
pa,haa	प,हा,ड़ाँ
maa,noo	मा,नूँ
lu,taa,ye	लु,टा,एँ
pa,ha,chaa,n	प,ह,चा,न
de,r	दे,ख्क,र
a,nu,sa,dhaa,n	अ,नु,सं,धा,न
la,da,n	लं,द,न
ga,ha,raa,yi	ग,ह,रा,ई
ba,dha,ka,r	ब,ढ़,क,र
gu,za,r,ne	गु,ज़,र,ने
gu,za,r,na	गु,ज़,र,ना
a,da,laa	अ,द,ला
de,va,taa,yon	दे,व,ता,ओं
kha,ri,da	ख,री,द
de,khe	दे,खे
sa,koo	स,कूँ
pa,da,ya,tra	प,द,या,त्रा
ba,da,n,si,ba	ब,द,न,सी,ब
cha,ma,ke,nge	च,म,कें,गे
ba,hi,n	ब,हि,याँ
tu,ka,don	टु,क,ड़ों
tu,ka,daa	टु,क,ड़ा
mu,skaa,na	मु,स्का,ना
tu,ka,de	टु,क,ड़े
sa,va,r,ti	सं,व,र,ती
chhu,ri,n	छु,रि,याँ
ha,ma,ri	ह,म,री
su,la,ga,te	सु,ल,ग,ते
su,la,ga,taa	सु,ल,ग,ता
sa,ma,jha,ne	स,म,झ,ने
sa,ma,jhaa,ne	स,म,झा,ने
sa,ma,jha,na	स,म,झ,ना
sa,ma,jhaa,na	स,म,झा,ना
da,r,na	ड,र,ना
a,n,jaa,ne	अ,न,जा,ने
a,n,jaa,ni	अ,न,जा,नी
la,ga,ste,sha,ns	ल,र्निं,ग, ,स्टे,श,न्स
sa,taa,o	स,ता,ओ
sa,ma,jha	स,म,झ
sa,ma,jhaa	स,म,झा
sa,ma,jhe	स,म,झे
sa,ma,jha	स,म,झ
ja,pa,ti	ज,प,ती
chhe,da,ne	छे,ड़,ने
shaa,ha,rru,kha	शा,ह,र्रु,ख
shaa,ha,ru,kha	शा,ह,रु,ख
pa,la,de	प,ल,ड़े
bi,chha,da,ka,r	बि,छ,ड़,क,र
ha,vaa,ye	ह,वा,एं
ja,za,baa,ta	ज,ज़,बा,त
moo	मूँ
mu,yi	मु,ई
chhu,pa,taa	छु,प,ता
ko,ma,la,taa	को,म,ल,ता
jhi,la,mi,laa,ne	झि,ल,मि,ला,ने
aa,ye	आ,ए
a,ye	अ,ए
ka,ha,laa,ya	क,ह,ला,य
di,kha,laa	दि,ख,ला
dha,da,ka,na	ध,ड़,क,ना
dha,da,ka,ne	ध,ड़,क,ने
gu,la,da,staa	गु,ल,द,स्ता
ba,taa,li,ya,n	ब,टा,लि,य,न
kaa,pa,ti	काँ,प,ती
choo	चूँ
cho,o,r	चो,ओ,र
fa,r,maa,te	फ़,र,मा,ते
fa,r,va,ri	फ़,र,व,री
to,ha,faa	तो,ह,फ़ा
chha,ma,ke	छ,म,के
su,r,mai,i	सु,र,मै,इ
mo,ha,bba,ta	मो,ह,ब्ब,त
ma,ya,khaa,ne	म,य,खा,ने
ta,la,ve	त,ल,वे
pa,laa,ni,ma,kka,ma	प,ला,नि,म,क्क,म
sa,di,n	स,दि,याँ
saa,di,ya	सा,दि,या
ma,ru	म,रूँ
maa,ru	मा,रूँ
mu,kha,daa	मु,ख,ड़ा
jhu,ka,te	झु,क,ते
ja,laa,n,gaa	ज,ला,ऊँ,गा
jaa,ye,n,nge	जा,ये,न,गे
a,khi,n	अ,खि,याँ
pa,tti,n	प,त्ति,याँ
dhoo,dha,na	ढूँ,ढ,ना
ye,ka,ju,ta	ए,क,जु,ट
gu,n,gu,na,ye	गु,न,गु,ना,ए
sa,faa,yi	स,फ़ा,यी
sa,faa,yi	स,फ़ा,ई
khu,la,ka,r	खु,ल,क,र
a,pa,raa,dha	अ,प,रा,ध
n,za,raa,na	न,ज़,रा,ना
sa,vaa,r,taa	स,वा,र,ता
na,zaa	ना,ज़ाँ
ma,jha,dhaa,r	मं,झ,धा,र
daa,li,n	डा,लि,याँ
5	4,5
do	4,2
da,r,vaa,je	द,र,वा,जे
ba,haa,ye	ब,हा,एं
tu,ma,ko	तु,म,को
duu,ba,ti	डू,ब,ती
duu,ba,taa	डू,ब,ता
duu,ba,te	डू,ब,ते
do,ha,raa,ye,gaa	दो,ह,रा,ये,गा
do,ha,raa,ye,gaa	दो,ह,रा,ए,गा
do,vaa,si,yon	दो,वा,सि,यों
paa,la,ne	पा,ल,ने
khu,la,ke	खु,ल,के
hi,ri,ye	ही,रि,ये
a,khi,ya,n	अं,खि,य,न
a,khi,n	अँ,खि,याँ
a,khi,n	अ,खि,याँ
kaa,r,gi	का,र,गी
vi,chho,de,n	वि,छो,ड़े,याँ
jaa,i,ye	जा,इ,ये
su,laa,ye	सु,ला,ए
raa,za,daa	रा,ज़,दाँ
ka,mpa,ni,yon	क,म्प,नि,यों
di,la,daa,raa	दि,ल,दा,रा
di,la,daa,r	दि,ल,दा,र
tha,ma,na	था,म,ना
a,bhi,ne,ntri,n	अ,भि,ने,त्रि,याँ
taa,le	ता,ले
ja,vaa,ha,r,laa,la	ज,वा,ह,र,ला,ल
a,ga,daa,yi	अं,ग,ड़ा,ई
jaa,yuu,gaa	जा,ऊं,गा
ba,da,li	ब,द,ली
ba,da,lo	ब,द,लो
ba,da,laa	ब,द,ला
ba,da,le	ब,द,लें
ba,da,le	ब,द,ले
sa,pa,ne	स,प,ने
ja,ga,la	जं,ग,ल
i,la,ya,sa	इ,ल,या,स
pa,r,chhaa,i,yon	प,र,छा,इ,यों
pa,chha,taa,ye	प,छ,ता,ये
bu,jha,taa	बु,झ,ता
sa,r,ga,mon	स,र,ग,मों
bu,jha,te	बु,झ,ते
bu,jha,ti	बु,झ,ती
swa,pa,ni,la	स्व,प,नि,ल
ma,n,mo,ha,n	म,न,मो,ह,न
bha,va,raa	भँ,व,रा
r,n,ga	र,न,ग
ka,rma	क,र्म
do	दो
to	तो
ma,ha,r,baa,n	म,ह,र,बा,न
me,ha,r,baa,n	मे,ह,र,बा,न
me,ha,r,baa	मे,ह,र,बां
to,o	तो,ओ
ti,sa,raa	ती,स,रा
faa,sa,laa	फ़ा,स,ला
aa,ya,ka,r	आ,य,क,र
ma,da,n,mo,ha,n	म,द,न,मो,ह,न
ta,n,haa,i,n	त,न,हा,इ,याँ
pri,ta,ma	प्री,त,म
bi,ye,sa,si	बी,ए,स,सी
ba,ha,ke	ब,ह,के
ba,ha,ki	ब,ह,की
du,haa,yi	दु,हा,ई
u,sa,ke	उ,स,के
ga,n,pa,ti	ग,ण,प,ति
ga,n,pa,ti	ग,ण,प,ती
na,choo	ना,चूँ
ha,vaa,ye	ह,वा,एं
ye,si,n	ए,सि,याँ
gu,la,sha,n	गु,ल,श,न
bha,va,re	भँ,व,रे
bha,va,raa	भँ,व,रा
chu,pa,chaa,pa	चु,प,चा,प
pa,he,li,n	प,हे,लि,याँ
raa,za,daa,r	रा,ज़,दा,र
chhaa,ye,gi	छा,ए,गी
ma,na,n,gi	म,ना,ऊँ,गी
frie,chaa,i,za	फ्रें,चा,इ,ज़
a,khi,n	अ,खि,याँ
a,khi,n	अँ,खि,याँ
n,ga,maa	न,ग,मा
n,ga,maa	न,ग़,मा
ma,cha,ne	म,च,ने
ta,la,vaa,r	त,ल,वा,र
ju,baa,ya,daa	जु,बा,य,दा
u,ja,da,ke	उ,ज,ड़,के
mu,sa,kaa,ne	मु,स,का,नें
phi,sa,le	फि,स,ले
i,tha,laa,ti	इ,ठ,ला,ती
5	5,8
da,ha,ka,taa	द,ह,क,ता
ta,da,pa,ke	त,ड़,प,के
ba,da,laa,va	ब,द,ला,व
ba,da,n,za,r	ब,द,न,ज़,र
i,r,shaa,da	इ,र,शा,द
sa,daa,ye	स,दा,एँ
se,vaa,ye	से,वा,एँ
chhu,aa	छु,आ
baa,ho	बा,हो
ka,ha,do	क,ह,दो
ke,ha,de	के,ह,दे
chi,r,taa,li,sa	चि,र,ता,लि,स
gu,n,gu,na	गु,न,गु,ना
ma,chha,li,n	म,छ,लि,याँ
aa,sa,maa,non	आ,स,मा,नों
sa,stha,n	सं,स्था,न
jha,ga,da,ne	झ,ग,ड़,ने
duu,be	डू,बे
chhu,paa,i,yo	छु,पा,इ,यो
ka,haa	क,हाँ
qu,da,r,ta	क़ु,द,र,त
ha,maa,re	ह,मा,रे
ja,n	ज,वाँ
traa,va,n,ko,r	ट्रा,व,ण,को,र
ba,da,na,mi	ब,द,ना,मी
r,cha,ne,vaa,li	र,च,ने,वा,ली
ha,la,vaa	ह,ल,वा
so,choo	सो,चूँ
pa,ha,chaa,n	प,ह,चा,न
shu,kra	शु,क्र
su,n,ha,re	सु,न,ह,रे
ma,hi,laa,ye	म,हि,ला,एँ
maa,ga,ne	माँ,ग,ने
a,bhi,ya,n	अ,भि,या,न
sa,ta,gu,ru	स,त,गु,रु
maa,ma,laa	मा,म,ला
chaa,hoo	चा,हूँ
chaa,hu	चा,हु
ba,ha,ka,taa	ब,ह,क,ता
so,cha,taa	सो,च,ता
r,ha,na	र,ह,ना
ni,r,la,ja	नि,र,ल,ज
mi,la,tin	मि,ल,तीं
na,zaa	ना,ज़ाँ
a,daa,o	अ,दा,ओ
a,daa,yon	अ,दा,ओं
di,khaa,ye	दि,खा,ए
di,khaa,o	दि,खा,ओ
di,khaa,yi	दि,खा,ई
ki,n	कि,न
ma,kha,ma,li	म,ख,म,ली
pa,ha,na,n,gaa	प,ह,ना,ऊँ,गा
de,kha,na	दे,ख,ना
de,kha,ne	दे,ख,ने
de,kha,n	दे,ख,न
de,kha,na	दे,ख,ना
de,kha,ni	दे,ख,नी
ba,r,saa,n	ब,र,सा,ऊँ
ka,pa,don	क,प,ड़ों
vaa,ha,non	वा,ह,नों
la,da,ti	ल,ड़,ती
bu,n,ka,ron	बु,न,क,रों
sa,vi,chaa,r	स,द्,‍, ,वि,चा,र
sa,bra	स,ब्र
chaa,bhi,n	चा,भि,याँ
sa,baa	स,बा
te,r,ha	ते,र,ह
sa,ma,jhaa,ye	स,म,झा,ये
sa,ma,jhaa,ye	स,म,झा,ए
sa,ma,jhaa,o	स,म,झा,ओ
byaa,ha	ब्या,ह
sho,le	शो,ले
u,thaa,n,gi	उ,ठा,ऊँ,गी
ya,ha	य,हँ
ya,haa	य,हाँ
ya,haa	य,हा
maa	माँ
maa,yon	मा,ओं
kha,ron,cha,ti	ख,रों,च,ती
sa,saa,dha,n	सं,सा,ध,न
cha,ha,ka,taa	च,ह,क,ता
bhaa,ja,paa	भा,ज,पा
zi,nda,gi	ज़ि,न्द,गी
la,gaa,yuu	ल,गा,ऊं
a,sha,daa,n	अं,श,दा,न
de,khe,nge	दे,खें,गे
maa,ye,ka,la	मा,ए,क,ल
cha,cha,la,taa	चं,च,ल,ता
chaa,ha,ne	चा,ह,ने
bai,chaa,yi,n	बै,चा,ई,न
pa,r,de,si	प,र,दे,सी
pa,r,de,shi	प,र,दे,शी
i,n,ki	इ,न,की
i,n,ki	इ,न,कि
paa,yi	पा,ईं
i,n,ko	इ,न,को
i,n,kaa	इ,न,का
i,n,ke	इ,न,के
i,n,ki	इ,न,की
sa,me,tu	स,मे,टूँ
pa,r	प,र
ye,sco,rt	ए,स्कॉ,र्ट
ki	कि
bi,la,ku,la	बि,ल,कु,ल
u,la,jha,ti	उ,ल,झ,ती
hoo	हूँ
pra,kaa,r	प्र,का,र
kaa,rya,vaa,hi	का,र्य,वा,ही
a,jaa,n	अं,जा,न
jaa,ne	जा,ने
aa,ma,tau,r	आ,म,तौ,र
me,ha,rbaa,ni,n	मे,ह,र्बा,नि,याँ
lai,laa,yon	लै,ला,ओं
mu,ga,le	मु,ग,ले
ba,na,ye	ब,ना,एं
ki	की
shri	श्री
saa,tha	सा,ठ, ,n,u,m
tha,ha,raa	ठ,ह,रा
vaa,di,n	वा,दि,याँ
khe,va,n,haa,r	खे,व,न,हा,र
pa,ha,na,yi	प,ह,ना,ई
u,la,jhaa,o,nge	उ,ल,झा,ओ,गे
jhuu,luu	झू,लूँ
pa,r,son	प,र,सों
ta,ma,nna,yon	त,म,न्ना,ओं
pa,r,chhaa,yi	प,र,छा,ई
bo,la,na	बो,ल,ना
ye,fa,aa,i,si,si,aa,i	ए,फ,आ,इ,सी,सी,आ,इ
bi,kha,raa,ye	बि,ख,रा,ये
da,ha,laa	द,ह,ला
kyaa	क्या
chu,n,ka,r	चु,न,क,र
u,taa,r,ne	उ,ता,र,ने
shri,kha,laa	श्रृं,ख,ला
ta,da,pa,ta	त,ड़,प,त
u,da,ne	उ,ड़,नें
u,da,ne	उ,ड़,ने
fa,na	फ,ना
tu,ma,ne	तु,म,ने
sa,taa,o,nge	स,ता,ओ,गे
ka,laa,yi	क,ला,ई
sa,ja,n,vaa	स,ज,न,वा
va,haa	व,हाँ
maa,n,vi,ya	मा,न,वी,य
saa,va,ri,ya	साँ,व,रि,या
sa,r,sa,raa,ha,ta	स,र,स,रा,ह,ट
bi,pa,daa	बि,प,दा
me,ha,n,ta	मे,ह,न,त
du,aa,ye	दु,आ,एं
u,mra	उ,म्र
ka,rma	क,र्म
pu,r,vaa,yi	पु,र,वा,ई
ha,sa,ne	हँ,स,ने
ha,sa,na	हँ,स,ना
ha,sa,na	हं,स,ना
gu,maa	ग़ु,माँ
gu,maa	गु,माँ
chha,la,kaa	छ,ल,का
chha,la,ke	छ,ल,के
mu,ma,taa,ja	मु,म,ता,ज
bha,laa,yi	भ,ला,ई
a,ka,don	आं,क,ड़ों
ma,ta,ki	म,ट,की
ba,r,saa,ton	ब,र,सा,तों
da,ri,ya,yon	द,रि,या,ओं
pi,chha,le	पि,छ,ले
ka,ha,te	क,ह,ते
ka,ha,tein	क,ह,तें
a,kha,baa,r	अ,ख,बा,र
gho,luu	घो,लूँ
gha,ba,raa,na	घ,ब,रा,ना
ba,r,baa,di,yon	ब,र,बा,दि,यों
ja,la,na	ज,ल,ना
bi,taa,n	बि,ता,ऊँ
mu,skaa,n	मु,स्का,न
da,fa,na,n,gi	द,फ़,ना,ऊँ,गी
phu,la,jha,di	फु,ल,झ,ड़ी
sa,gaa,yi	स,गा,ई
ke,ha,di	के,हं,दी
ku,da,ga,rzi	ख़ु,द,ग,र्ज़ी
khu,da,ga,rzi	खु,द,ग,र्ज़ी
gho,la,ti	घो,ल,ती
di,la,ka,shi	दि,ल,क,शी
u,n,se	उ,न,से
ta,ma,nge	त,म,गे
maa,noo	मा,नूँ
stha,pa,na	स्था,प,ना
r,ghu,raa,yi	र,घु,रा,ई
he,ga,de	हे,ग,डे
jaa,yuu,gaa	जा,ऊं,गा
jaa,n,gaa	जा,ऊँ,गा
ho,n,haa,r	हो,न,हा,र
sho,o,le	शो,ओ,ले
ma,ha,suu,sa	म,ह,सू,स
ja,ga,di,shva,r,ma	ज,ग,दी,श्व,र,म
bhaa,yi	भा,ई
ba,ha,sa	ब,ह,स
bhi	भी
baa	बा
pa,la,ki,n	प,ल,कि,याँ
ho,te	हो,ते
di,vaa,ne	दी,वा,ने
ka,ru	क,रूँ
be,ni,shaa	बे,नि,शाँ
ji,sa,ne	जि,स,ने
jo,doo	जो,ड़ूँ
boo,nda,ni,n	बू,न्द,नि,याँ
poo,chha,te	पू,छ,ते
poo,chha,ti	पू,छ,ती
ta,nhaa,yi,yaan	त,न्हा,ई,यां
ta,n,haa,i,n	त,न,हा,इ,याँ
ta,n,haa,yi,n	त,न,हा,ई,याँ
ta,nhaa,i,yaan	त,न्हा,इ,यां
7,6	7,6
laa,ye,gi	ला,ए,गी
laa,ye,gaa	ला,ए,गा
mi,la,vaa,ya	मि,ल,वा,या
aa,r,ti,o	आ,र,टी,ओ
la,ka,di	ल,क,ड़ी
gi,raa	गि,राँ
gi,raa,o	गि,रा,ओ
dhoo,dha,ti	ढूँ,ढ,ती
chha,la,ne	छ,ल,ने
cha,la,ne	च,ल,ने
cha,la,na	च,ल,ना
cha,la,ni	च,ल,नी
chha,la,ni	छ,ल,नी
mu,skaa,ye,gaa	मु,स्का,ए,गा
te,la,gi	ते,ल,गी
pi,laa,n,gi	पि,ला,ऊँ,गी
ba,ha,ka,taa	ब,ह,क,ता
paa,ye,gi	पा,ए,गी
sa,jaa,i,ke	स,जा,इ,के
a,pa,ni	अ,प,नी
5,3,5	5,3, ,5,4
a,pa,na	अ,प,ना
a,pa,ne	अ,प,ने
u	उ,ठ्ति
frie,chaa,i,za	फ्रें,चा,इ,ज़
thu,ka,raa,na	ठु,क,रा,ना
ka,ri,do,nge	ख़,री,दो,गे
6,a,pri,la	6, ,अ,प्रि,ल
ba,taa,ye	ब,ता,ए
ba,taa,yi	ब,ता,ई
ba,taa,o	ब,ता,ओ
tu,faa	तु,फ़ा,नोँ
ki,sa,ki	कि,स,की
ki,sa,ko	कि,स,को
traa,va,n,ko,r	ट्रा,व,ण,को,र
ki,sa,kaa	कि,स,का
ki,sa,ke	कि,स,के
fa,la,sa,faa	फ,ल,स,फा
ba,dha,ke	ब,ढ़,के
	c,a,n,n,o,t, ,u,n,d,e,r,s,t,a,n,d
khu,la,te	खु,ल,ते
khi,la,taa	खि,ल,ता
khu,la,taa	खु,ल,ता
khu,la,ti	खु,ल,ती
ta,nhaa,yi,yon	त,न्हा,ई,यों
ye,ka,di,va,si,ya	ए,क,दि,व,सी,य
lo,taa,ga,n	लो,टां,ग,ण
baa,la,kri,shna,n	बा,ल,कृ,ष्ण,न
gu,n,gu,na,n	गु,न,गु,ना,ऊँ
thu,ka,raa,o	ठु,क,रा,ओ
thu,ka,raa,ye	ठु,क,रा,ए
ru,ka,daa	रु,क,दा
bi,taa,yi	बि,ता,ई
kha,na,yi,ya	ख,ना,ई,या
ma,ha,koo	म,ह,कूँ
chaa,raa,ga,raa	चा,रा,ग,राँ
khuu,ba,suu,r,ta	खू,ब,सू,र,त
koo,ba,suu,r,ta	ख़ू,ब,सू,र,त
baa,r,le	बा,र,ले
yi,da,u,la,phi,tta,r	ई,द,उ,ल,फि,त्त,र
khi,da,ki,yaan	खि,ड़,कि,यां
cha,dhaa,ye	च,ढ़ा,एँ
mi,laa,ye	मि,ला,एँ
n,ha,laa	न,ह,ला
du,aa,re	दु,आ,रे
ru,pa,ye	रु,प,ये
a,ma,ri,ki	अ,म,री,की
sa,ha,raa	स,ह,रा
laa,ye	ला,एँ
laa,ye	ला,येँ
sa,vi,chaa,r	स,द्,‍, ,वि,चा,र
so,ha,r,ta	सो,ह,र,त
bha,r,poo,r	भ,र,पू,र
li,pa,taa,ye	लि,प,टा,ए
mi,laa,ye,nge	मि,ला,एं,गे
ga,yi	ग,ई
ta,ka,raa,ye	ट,क,रा,ए
bhaa,ga,ne	भा,ग,ने
haa	हाँ
bhaa,ga,na	भा,ग,ना
paa,yuu,di	पा,ऊं,दी
su,la,jhaa,o	सु,ल,झा,ओ
to,doo	तो,ड़ूँ
u,chha,la,ka,r	उ,छ,ल,क,र
ndi,ti,ye,cha	डी,टी,ए,च
da,ga,ma,ga	ड,ग,म,ग
a,dhi,kaa,ri,yon	अ,धि,का,रि,यों
ta,la,ba,gaa,r	त,ल,ब,गा,र
a,pa,na,yuu,gaa	अ,प,ना,ऊं,गा
gu,n,gu,na,ne	गु,न,गु,ना,ने
ta,n,ti	त,न,ती
chaa,ha,taa	चा,ह,ता
ha,ma,na,ya,sa	ह,म,ना,य,स
ta,n,haa,i,n	त,न,हा,इ,याँ
ta,n,haa,yi,n	त,न,हा,ई,याँ
ka,ro,do	क,रो,ड़ो
bhu,laa,ye	भु,ला,ए
bhu,laa,yi	भु,ला,ई
vi,dha,vaa	वि,ध,वा
n,chaa,n	न,चा,ऊँ
ju,ga,nu,yon	जु,ग,नु,ओं
r,li,n	र,लि,याँ
sa,faa,yi	स,फ़ा,ई
ba,taa,yi	ब,ता,ई
ba,taa,o	ब,ता,ओ
sa,za,daa	स,ज़,दा
ga,r,da,n	ग,र,द,न
ja,ga,ma,gaa,yi	ज,ग,म,गा,ई
la,daa,o	ल,ड़ा,ओ
la,daa,yi	ल,ड़ा,ई
chu,raa,ye	चु,रा,ए
chu,raa,yi	चु,रा,ई
chu,raa,ya	चु,रा,य
ka,pa,de	क,प,ड़े
chu,raa,o	चु,रा,ओ
ha,n	ह,वाँ
ha,vaa,o	ह,वा,ओ
ha,vaa,yon	ह,वा,ओं
ha,vaa,yi	ह,वा,ई
bri,daa,pa,n	ब्रिं,दा,प,न
ka,ha,laa,ye	क,ह,ला,येँ
ta,ka,raa,ye	ट,क,रा,ए
ta,ka,raa,yi	ट,क,रा,ई
ta,ka,raa,o	ट,क,रा,ओ
si,ma,taa,yi	सि,म,टा,ई
de,va,gha,r	दे,व,घ,र
u,daa,si,n	उ,दा,सि,याँ
ju,laa,yi	जु,ला,ई
ba,taa,o	ब,ता,ओ
di,kha,laa,ya	दि,ख,ला,य
di,kha,laa,ya	दि,ख,ला,या
sa,ma,jhaa,i,ye	स,म,झा,इ,ये
ka,ha,te	क,ह,ते
ka,ha,laa,n,gaa	क,ह,ला,ऊँ,गा
mu,mba,yi	मु,म्ब,ई
taa,ja,gi	ता,ज,गी
khu,ma,ri,ya	खु,म,रि,या
a,r,maa	अ,र,मां
a,r,maa,n	अ,र,मा,न
a,rmaa	अ,र्मा
a	अ,र्माँ
ba,n,na	ब,न,ना
ba,n,ne	ब,न,ने
mi,cho,li,n	मि,चो,लि,याँ
na,cha,ke	ना,च,के
do,o,sa,ri	दो,ओ,स,री
jhaa,laa	झा,ला
chu,la,bu,le	चु,ल,बु,ले
ma,ha,ka,na	म,ह,क,ना
to,ha,kaa,hin	टो,ह,का,हीं
bi,ga,di	बि,ग,ड़ी
ye,va	ए,वं
ka,haa	क,हाँ
ka,haa	क,हाँ
ka,haa	क,हा
bho,le	भो,ले
ba,da,la,ne	ब,द,ल,ने
su,r,maa,yi	सु,र,मा,ई
gu,la,zaa,r	गु,ल,ज़ा,र
ba,da,la,na	ब,द,ल,ना
a,dhya,ksha,taa	अ,ध्य,क्ष,ता
ga,ha,raa,yi	ग,ह,रा,ई
vi,she,sha,taa,yon	वि,शे,ष,ता,ओं
ha,sa,ni	हँ,स,नी
ma,ja,raa	म,ज,रा
ba,r,jo,ri	ब,र,जो,री
su,ku,maa,ri,n	सु,कु,मा,रि,याँ
daa,mi,ni,n	दा,मि,नि,याँ
ga,la,ne	ग,ल,ने
raa,ston	रा,स्तों
ha,sa,ne	हँ,स,ने
a,ga,raa,yi	अं,ग,रा,ई
mi,ya,mi	मि,या,मी
ma,ta,vaa,re	म,त,वा,रे
ma,hu,aa	म,हु,आ
ba,jaa,ye,nge	ब,जा,एं,गे
su,laa,yuu	सु,ला,ऊं
r,kha,taa	र,ख,ता
aa,vaa,r,gi	आ,वा,र,गी
r,kha,ti	र,ख,ती
la,pe,tu	ल,पे,टूँ
di,shaa,ye	दि,शा,एं
sau,daa,yi	सौ,दा,ई
li,khuu	लि,खूँ
raa,na,i,n	रा,ना,इ,याँ
va	व
sa,ka,taa	स,क,ता
hu,sna,vaa,lo	हु,स्न,वा,लो
a,pa,na	अ,प,ना
na,choo	ना,चूँ
r,ha,ma,ta	र,ह,म,त
ba,noo	ब,नूँ
ja,pa,ti	ज,प,ती
r,ha,maa,n	र,ह,मा,न
ja,pa,taa	ज,प,ता
lu,ta,na	लू,ट,ना
qa,rbaa,n	क़,र्बा,न
qu,r,baa	क़ु,र,बाँ
phi,raa	फि,राँ
ju,baa,ya,daa	जु,बा,य,दा
ba,dhaa,o	ब,ढ़ा,ओ
ba,dhaa,yi	ब,धा,ई
ba,dhaa,yi	ब,ढ़ा,ई
da,la,da,la	द,ल,द,ल
lo,r,ha	लो,र,ह
aa,saa	आ,साँ
fi,zaa,ye	फ़ि,ज़ा,एं
na,ya,duu	ना,य,डू
n,ga,r,pa,ti	न,ग,र,प,ति
na,kaa,mi,n	ना,का,मि,याँ
sa,di,n	स,दि,योँ
ta,da,paa,o	त,ड़,पा,ओ
pri,ta	प्री,त
chu,n,ri	चु,न,री
gu,za,ru	गु,ज़,रूँ
chu,ta,ki	चु,ट,की
ho,ye	हो,ए
ho,o	हो,ओ
ho,i	हो,इ
ho,yi	हो,ई
ga,r,ja,taa	ग,र,ज,ता
hoo	हूँ
hai	है
la,ha,raa	ल,ह,रा
ba,n,maa	ब,न,मा
ki,ji,ye,ye	की,जि,ये,ए
a,mi,r,zaa,di	अ,मी,र,ज़ा,दी
n,r,mi	न,र,मी
6,5	6,4, ,8,4,5
sa,sa,te	स,स,ते
ha,ma,da,rd	ह,म,द,र्द
ba,ta,laa,na	ब,त,ला,ना
ba,ta,laa,ne	ब,त,ला,ने
go,vi,nda,gha,ta	गो,वि,न्द,घा,ट
kra,maa,ka	क्र,मां,क
jho,li,n	झो,लि,याँ
ba,aa	ब,द्दु,आ
so,ni,ya	सो,नि,या
ha,ma,raa,ha	ह,म,रा,ह
bhin,ga,na	भीं,ग,ना
ha,ma,raa,za	ह,म,रा,ज़
5,5	5,4,5
kyaa	क्या
sa,ma,jha,ta	स,म,झ,त
aa,o,ni	आ,ओ,नी
sa,ma,jhaa,o	स,म,झा,ओ
sa,ma,jhaa	स,म,झा
bu,jhaa,ye	बु,झा,एं
kaa	का
ba,ti,n	ब,ति,याँ
ra,ga,r,si,ya	रं,ग,र,सि,या
a,khi,n	अ,खि,याँ
pu,kaa,r,taa	पु,का,र,ता
ya,haa,yon	य,हा,ओं
mu,aa,ma,laa	मु,आ,म,ला
ma,ja,noo	म,ज,नूँ
du,sa,ri	दू,स,री
du,sa,raa	दू,स,रा
du,sa,re	दू,स,रे
u,ma,r	उ,म,र
fa,r,maa,ye	फ़,र,मा,यें
ta,r,saa,n,gaa	त,र,सा,ऊँ,गा
li,pa,ta,na	लि,प,ट,ना
jaa,yi	जा,ई
ba,taa,li,ya,n	ब,टा,लि,य,न
ba,da,la,taa	ब,द,ल,ता
ja,vaa,ni,n	ज,वा,नि,याँ
jaa,n,pu,r	जा,न,पु,र
du,yi	दु,ई
kaa,rya,kra,mon	का,र्य,क्र,मों
a,ka,don	आं,क,ड़ों
sa,taa,yuu,gaa	स,ता,ऊं,गा
sa,taa,n,gaa	स,ता,ऊँ,गा
ba,la,khaa,ti	ब,ल,खा,ती
dha,la,ne	ढ,ल,ने
sho,ha,r,ta	शो,ह,र,त
ba,r,baa,di	ब,र,बा,दी
sa,fe,di,n	स,फ़े,दि,याँ
ja,luu	ज,लूँ
ha,lke	ह,ल्के
pra,dhaa,n,ma,tri	प्र,धा,न,मं,त्री
ki,sa,se	कि,स,से
jaa	जा
mo,da,taa	मो,ड़,ता
paa,ye,gaa	पा,ए,गा
ki,sa,li,ye	कि,स,लि,ये
ki,sa,li,ye	कि,स,लि,ए
nau,ka,ri	नौ,क,री
smaa,ve,sha	स्मा,वे,श
ba,sa,na	ब,स,ना
ba,sa,ne	ब,स,ने
me,he,r,baa,n	मे,हे,र,बा,न
ma,ha,r,baa,n	म,ह,र,बा,न
me,ha,r,baa,n	मे,ह,र,बा,न
me,ha,r,baa	मे,ह,र,बां
a,sa,li	अ,स,ली
ya,haa	य,हाँ
i,kaa,i,yon	इ,का,इ,यों
ka,ha,ka,shaan	क,ह,क,शां
thu,ka,raa,yi	ठु,क,रा,ई
bri,daa,ba,n	ब्रिं,दा,ब,न
bai,tha,ke	बै,ठ,के
ja,ga,ma,gaa,ke	ज,ग,म,गा,के
vi,shva,na,th,n	वि,श्व,ना,थ,न
maa,n,si,ka	मा,न,सि,क
maa,n,si,la	मा,न,सि,ल
ba,dho,tta,ri	ब,ढ़ो,त्त,री
pa,dmi,ni,n	प,द्मि,नि,याँ
sha,rmaa,te	श,र्मा,ते
u,lle,kha,ni,ya	उ,ल्ले,ख,नी,य
u,la,jhe,gaa	उ,ल,झे,गा
gya,n	ज्ञा,न
ga,ya	ग,या
gha,ba,raa,ye,gi	घ,ब,रा,ए,गी
mi,ta,vaa	मि,त,वा
lo,ka,sa,bhaa	लो,क,स,भा
be,ha,raa	बे,ह,रा
ni,shu,lk	नि,:,शु,ल्क
kaa,tu	का,टूँ
su,na,yuu	सु,ना,ऊं
ma,n,mo,ha,na	म,न,मो,ह,ना
ni,ka,la,ne	नि,क,ल,ने
pa,ri,yo,ja,na	प,रि,यो,ज,ना
sa,r,kaa	स,र,का
sa,da,bu,ddh	स,द,बु,द्ध
sa,r,ke	स,र,के
raa,sha,ya	रा,ष,ट्री,य
ni,rbha,r,taa	नि,र्भ,र,ता
si,r,haa,ne	सि,र,हा,ने
vi,shva,na,th,n	वि,श्व,ना,थ,न
pi,ka,ni,ka	पि,क,नि,क
ro,ke	रो,के
yo,ja,na	यो,ज,ना
a,th,vaa	अ,थ,वा
ba,r,se	ब,र,सें
ba,r,se	ब,र,से
ba,r,se	ब,र,से,‘
ba,r,saa	ब,र,सा
ba,r,so	ब,र,सो
ba,r,son	ब,र,सों
ba,r,si	ब,र,सी
saa	सा
saa	सा
saa	सा
jo,doo	जो,ड़ूँ
pa,dha,vaa,ya	प,ढ़,वा,या
ka,ha,ti	क,ह,ती
ka,ha,ti	क,ह,ती
ka,ha,te	क,ह,ते
ka,ha,tein	क,ह,तें
ka,ha,taa	क,ह,ता
chhaa,ye	छा,ए
ka,haa	क,हाँ
suu,cha,na	सू,च,ना
le,ka,r	ले,क,र
ka,re,ja,vaa	क,रे,ज,वा
ma,da,ho,shi,n	म,द,हो,शि,याँ
ta,n,haa,yi	त,न,हा,ई
ma,ha,suu,sa	म,ह,सू,स
a,la,baa,baa,baa	अ,ल,बा,बा,बा
di,la,pa,r	दि,ल,प,र
pa,cha,ha,tta,r	प,च,ह,त्त,र
pi,yuu	पि,यूँ
to,li,n	टो,लि,याँ
n,ma,ki,n	न,म,की,न
ba,chaa,o	ब,चा,ओ
chhu,ta,ka,r	छु,ट,क,र
gu,ja,r,ti	गु,ज,र,ती
pa,laa,ni,ma,kka,ma	प,ला,नि,म,क्क,म
yi,da,u,la,phi,tta,r	ई,द,उ,ल,फि,त्त,र
n,ga,mon	न,ग़,मों
ja,taa,o,nge	ज,ता,ओ,गे
bu,laa,n	बु,ला,ऊँ
ka,ba,hoo	क,ब,हूँ
la,ha,ren	ल,ह,रें
a,ga,daa,i,n	अँ,ग,ड़ा,इ,याँ
i,ma,li	इ,म,ली
gu,da,gu,daa,ye,gi	गु,द,गु,दा,यें,गी
sa,gra,haa,ka,la,ya	सं,ग्र,हा,क,ल,य
noo	नूँ
bi,sa,ri	बि,स,री
bi,sa,raa	बि,स,रा
bi,chha,da,na	बि,छ,ड़,ना
pa,ha,ne	प,ह,ने
gu,zaa,re	गु,ज़ा,रे
la,jaa,o	ल,जा,ओ
la,jaa,yi	ल,जा,ई
fa,sa,le	फ,स,लें
ga,r,da,n	ग,र,द,न
do,ha,raa,ye	दो,ह,रा,एँ
de,kha,bhaa,la	दे,ख,भा,ल
cha,ma,kaa,o	च,म,का,ओ
cha,ma,kaa,ye	च,म,का,ए
khu,daa,yi	खु,दा,ई
tu,ma,se	तु,म,से
ma,luu	म,लूँ
gu,n,gu,na,o	गु,न,गु,ना,ओ
chu,raa,te	चु,रा,ते
chha,la,kaa,ya	छ,ल,का,या
u,sa,ki	उ,स,की
taa,re	ता,रे
gha,ba,raa,ke	घ,ब,रा,के
do,ha,raa,n	दो,ह,रा,ऊँ
jaa,noo	जा,नूँ
va,faa,ye	व,फ़ा,एं
n,za,raa,na	न,ज़,रा,ना
ma,chaa,yi	म,चा,ई
su,na,n,gi	सु,ना,ऊँ,गी
jaa,n,ne	जा,न,ने
ho,gaa	हो,गा
mi,khaa,i,la	मि,खा,इ,ल
a,pa,ni	अ,प,नी
su,koo	सु,कूँ
sau,daa,yi	सौ,दा,ई
ti,i,n	ती,इ,न
ka,ha,ne	क,ह,ने
ka,ha,na	क,ह,ना
maa,li,ka	मा,लि,क
la,ha,raa,ye	ल,ह,रा,ये
ha,vaa,yon	ह,वा,ओं
aa,na,da,ma,yi	आ,नं,द,म,यी
i,ta,kaa,ma	इं,त,का,म
ha,sa,ka,r	हँ,स,क,र
sa,vaa,ri,n	स,वा,रि,याँ
yi,da,u,la,phi,tta,r	ई,द,उ,ल,फि,त्त,र
aa,i,ti,si	आ,इ,टी,सी
dhu,la,te	धु,ल,ते
dhu,la,taa	धु,ल,ता
gha,taa,yon	घ,टा,ओं
n,za,ren	न,ज़,रें
mi,n	मि,याँ
aa,r,zu	आ,र,ज़ू
i,ga,lai,nd	इं,ग,लै,न्ड
faa,ya,daa	फ़ा,य,दा
aa,r,zu	आ,र,ज़ू
zi,kra	ज़ि,क्र
kha,taa,yon	ख,ता,ओं
ta,maa,shaa,yi	त,मा,शा,ई
jaa,ye,gi	जा,ये,गी
che,ha,raa	चे,ह,रा
ni,haa,r,taa	नि,हा,र,ता
ta,da,paa,ye	त,ड़,पा,ए
ta,da,paa,ye	त,ड़,पा,ये
ta,da,paa,ye	त,ड़,पा,एँ
ta,da,paa,ye	त,ड़,पा,यें
aa,ye	आ,एं
ha,la,vaa	ह,ल,वा
ru,sa,vaa,i,yaan	रु,स,वा,इ,यां
jaa,n,ne	जा,न,ने
pa,rva,r,di,gaa,r	प,र्व,र,दि,गा,र
pa,r,va,rdi,gaa,r	प,र,व,र्दि,गा,र
bha,r,ke	भ,र,के
pi,chha,le	पि,छ,ले
pi,chha,li	पि,छ,ली
cha,r,non	च,र,णों
pa,dha,ne	प,ढ़,ने
pa,dha,ne	प,ढ़,ने
pa,dha,na	प,ढ़,ना
do,ha,raa,ye,gi	दो,ह,रा,एं,गी
la,ha,raa	ल,ह,रा
vi,chaa,ri,n	वि,चा,रि,याँ
aa,kaa,sha,vaa,ni	आ,का,श,वा,णी
baa,rg,li	बा,र्ग,ली
chu,raa,n	चु,रा,ऊँ
gvaa,li,ya,r	ग्वा,लि,य,र
a,ga,daa,yi	अँ,ग,ड़ा,ई
a,ga,daa,yi	अं,ग,ड़ा,ई
sha,ta,ra,ja	श,त,रं,ज
ku,shi,n	ख़ु,शि,याँ
khu,shi,n	खु,शि,याँ
ka,ha,laa,ye	क,ह,ला,ये
gi,raa,o,nge	गि,रा,ओ,गे
pa,la,ke	प,ल,के
pa,la,ke	प,ल,कें
pa,la,kon	प,ल,कों
paa,la,ki	पा,ल,की
sa,u,di	स,उ,दी
so,choo	सो,चूँ
a,n,chhu,yi	अ,न,छु,ई
yu,vaa,yon	यु,वा,ओं
khe,la,na	खे,ल,ना
chho,da,ka,r	छो,ड़,क,र
zi,da,gi	ज़िं,द,गी
chhaa,yon	छा,ओं
khi,laa,o,gi	खि,ला,ओ,गी
stha,pa,na	स्था,प,ना
gha,ba,raa,o	घ,ब,रा,ओ
aa,za,maa,ye,nge	आ,ज़,मा,एं,गे
di,vaa,n,gi	दी,वा,न,गी
pu,rvaa,yi	पु,र्वा,ई
pu,r,vaa,yi	पु,र,वा,ई
vaa,li,ye	वा,लि,ए
di,la,daa,ri	दि,ल,दा,री
i,ta,vaa,r	इ,त,वा,र
faa,sa,laa	फा,स,ला
faa,sa,laa	फ़ा,स,ला
su,n,ha,raa	सु,न,ह,रा
faa,sa,le	फा,स,लें
su,n,ha,re	सु,न,ह,रे
taa,li,n	ता,लि,याँ
pa,r,chaa	प,र,चा
pa,lke,n	प,ल्के,न
da,ma,ke	द,म,के
r,smon	र,स्मों
ba,saa,ye	ब,सा,एं
li,kha,te	लि,ख,ते
li,kha,taa	लि,ख,ता
li,kha,ti	लि,ख,ती
pa,r,vaa,na	प,र,वा,ना
cha,dha,ke	च,ढ़,के
ka,rma	क,र्म
du	दूँ
du,ga,na	दु,ग,ना
vaa,sa,ni,ka	वा,स,नि,क
ka,mpa,ni,n	क,म्प,नि,याँ
ma,ja,noo	म,ज,नूँ
la,gaa,yi	ल,गा,ई
jhe,la,taa	झे,ल,ता
la,gaa,o	ल,गा,ओ
la,gaa,ye	ल,गा,ए
de,kha,taa	दे,ख,ता
i,dra,sa,n	इं,द्रा,स,न
r,kha,na	र,ख,ना
ta,r,sa	त,र,स
ki,sa,ma,ta	कि,स,म,त
pa,cha,ha,tta,r	प,च,ह,त्त,र
ghoo,ma,ne	घू,म,ने
ro,ti,n	रो,टि,याँ
khu,da,ko	खु,द,को
bu,laa,ye,gaa	बु,ला,ए,गा
mu,shqi,lon	मु,श्क़ि,लों
ba,noo	ब,नूँ
sa,ma,jha,te	स,म,झ,ते
qu,r,baa,ni	क़ु,र,बा,नी
di,la,ba,ron	दि,ल,ब,रों
di,khaa,n,gi	दि,खा,ऊँ,गी
swaa,sthya,ma,tri	स्वा,स्थ्य,मं,त्री
ja,laa,o	ज,ला,ओ
di,la,ru,baa	दि,ल,रु,बा
ja,haa	ज,हाँ
aa,n,gi	आ,ऊँ,गी
n,ga,me	न,ग़,में
n,ga,me	न,ग,में
aa,n,gaa	आ,ऊँ,गा
ta,ka,raa,ye,gi	ट,क,रा,ए,गी
di,shaa,yon	दि,शा,ओं
di,khaa,yi	दि,खा,ई
gha,taa,yon	घ,टा,ओं
ma,ha,ke,gaa	म,ह,के,गा
gu,di,ya	गु,ड़ि,या
gu,di,n	गु,ड़ि,याँ
ga,rmi,n	ग,र्मि,याँ
n,ga,maa	न,ग,मा
n,ga,maa	न,ग़,मा
pi,gha,le	पि,घ,ले
n,ga,me	न,ग,मे
n,ga,me	न,ग़,मे
pi,gha,laa	पि,घ,ला
be,qa,raa,ri	बे,क़,रा,री
gha,ba,raa,ti	घ,ब,रा,ती
bhaa,ja,paa	भा,ज,पा
aa,ga,na	आँ,ग,ना
a,ga,na	अं,ग,ना
bu,za,di,lon	बु,ज़,दि,लों
ru,ka,taa	रु,क,ता
ru,ka,te	रु,क,ते
ba,na,yi	ब,ना,ई
ha,r,jaa,yi	ह,र,जा,ई
ni,ka,la,ne	नि,क,ल,ने
mu,jha,pa,r	मु,झ,प,र
pi,cha,kaa,ri	पि,च,का,री
ha,ma,pe	ह,म,पे
da,r,bha,gaa	द,र,भं,गा
chho,de,nge	छो,ड़ें,गे
nu,maa,yi	नु,मा,ई
nu,maa	नु,माँ
u,thaa,yi	उ,ठा,ई
u,thaa,o	उ,ठा,ओ
va,rta,maa,n	व,र्त,मा,न
ta,svi,r	त,स्वी,र
bi,kha,raa	बि,ख,रा
a,ha,ma,daa,baa,da	अ,ह,म,दा,बा,द
bi,kha,re	बि,ख,रे
za,kmi	ज़,ख़्मी
ha,ma,n,n	ह,म,न,वाँ
ba,haa,u,gaa	ब,हा,उं,गा
ta,mma,n,na	त,म्मा,न,ना
raa,ja,swa	रा,ज,स्व
bi,taa,ye	बि,ता,एँ
bi,kha,raa,ye	बि,ख,रा,ए
ga,tha,ba,dha,n	ग,ठ,बं,ध,न
re,khaa,ye	रे,खा,एँ
ko,taa	को,टा
ba,ha,ne	ब,ह,ने
baa,rg,li	बा,र्ग,ली
u,da,ke	उ,ड़,के
nge,su,yon	गे,सु,ओं
sha,r,maa,i,ye	श,र,मा,इ,ये
be,ka,raa,ri,n	बे,क,रा,रि,याँ
la,mhon	ल,म्हों
frie,chaa,i,za	फ्रें,चा,इ,ज़
khwaa,i,shen	ख्वा,इ,शें
bhe,ja,ne	भे,ज,ने
di,la,ba,r	दि,ल,ब,र
ba,da,raa	ब,द,रा
ba,da,ri	ब,द,री
ghu,la,ti	घु,ल,ती
mi,laa,o	मि,ला,ओ
mi,laa,yi	मि,ला,ई
mi,laa,ya	मि,ला,य
mi,laa,ye	मि,ला,ए
mi,laa,n	मि,ला,ऊँ
du,aa,ye	दु,आ,एँ
ma,ta,la,ba	म,त,ल,ब
aa,sa,raa	आ,स,रा
ko,ha,re	को,ह,रे
raa,ma,dhaa,ri	रा,म,धा,री
sha,ta,ra,ja	श,त,रं,ज
mi,le,nge	मि,लें,गे
ba,ha,laa,ye,gaa	ब,ह,ला,ए,गा
ya	या
be,taa,bi,n	बे,ता,बि,याँ
mi,luu	मि,लूँ
la,ha,raa,ne	ल,ह,रा,ने
u,lle,kha,ni,ya	उ,ल्ले,ख,नी,य
fi,zaa,ye	फ़ि,ज़ा,एं
sa,pa,non	स,प,नों
sa,pa,non	स,प,नों
bo,li,ye	बो,लि,ए
ka,da,mon	क,द,मों
vi,r,ja,n	वि,र,ज,न
hu,ye	हु,ए
hu,aa	हु,आ
sha,ta,ra,ja	श,त,रं,ज
ma,ha,maa,n	म,ह,मा,न
me,ha,maa,n	मे,ह,मा,न
sa,vaa,ru	सँ,वा,रूँ
ba,taa,yuu	ब,ता,ऊं
a,va,she,sha	अ,व,शे,ष
u,ja,da,te	उ,ज,ड़,ते
khwaa,ba	ख्वा,ब
ma,ta,la,ba	म,त,ल,ब
jhi,jha,ka,ne	झि,झ,क,ने
sa,ma,jha,na	स,म,झ,ना
sa,ma,jha,ne	स,म,झ,ने
bi,chha,de	बि,छ,ड़े
bi,chha,daa	बि,छ,ड़ा
do,sau,sau,sau,5	2,0,0,4, ,0,5
khu,n,khu,n	खु,न,खु,न
bi,r,haa	बि,र,हा
bi,r,ha	बि,र,ह
khaa,ye,nge	खा,एं,गे
khaa,ye,nge	खा,एँ,गे
haa	हाँ
ga,ha,raa,yi,yaan	ग,ह,रा,ई,यां
1,7,3	1,9,7,3
ba,haa,o	ब,हा,ओ
shaa,ha	शा,ह
ba,haa,yi	ब,हा,ई
aa,ya	आ,या
sa,mbhaa,luu	स,म्भा,लूँ
laa,o	ला,ओ
laa,yi	ला,ई
laa	ला
paa,ye	पा,एँ
si,khaa,n,gaa	सि,खा,ऊँ,गा
laa,u	ला,उ
va,haa	व,हाँ
me,ha,maa,n	मे,ह,मा,न
pra,vri,tti,n	प्र,वृ,त्ति,याँ
ja,ba,r,da,sta	ज,ब,र,द,स्त
na,za,nee	ना,ज़,नीं
u,ja,ri	उ,ज,री
di,ji,ye	दी,जि,ए
a,daa,ye	अ,दा,एँ
a,ga,n	आं,ग,न
a,ga,n	अं,ग,न
ka,raa,n	क,रा,ऊँ
baa,ka,pa,n	बाँ,क,प,न
u,sa,kaa	उ,स,का
di,la,n,vaa,zi	दि,ल,न,वा,ज़ी
su,na,n,gaa	सु,ना,ऊँ,गा
ga,tha,ba,dha,n	ग,ठ,बं,ध,न
pa,ha,chaa,hoo	प,ह,चा,हूँ
ta,nhaa,i,n	त,न्हा,इ,याँ
a,ha,ma,da	अ,ह,म,द
do,ston	दो,स्तों
ka,ma,ri,ya	क,म,रि,या
de,kha,ke	दे,ख,के
ba,ne	ब,ने
be,va,faa,yi	बे,व,फ़ा,ई
chu,raa,yuu	चु,रा,ऊं
ni,ka,la,na	नि,क,ल,ना
ni,kaa,la,na	नि,का,ल,ना
ta,qa,di,ren	त,क़,दी,रें
ko,yi	को,ई
kho,yi	खो,ई
yi,da,u,la,phi,tta,r	ई,द,उ,ल,फि,त्त,र
maa	माँ
ta,qa,di,ren	त,क़,दी,रें
jhaa,koo	झा,कूँ
ka,sa,r,ta	क,स,र,त
be,ka,raa,ri	बे,क,रा,री
ja,maa,yi	ज,मा,ई
jaa,ye	जा,ये
shi,ka,ve	शि,क,वे
shi,ka,vaa	शि,क,वा
chu,kaa	चु,का
la,di,n	ल,ड़ि,याँ
sa,hoo	स,हूँ
o,stra,li,ya,yi	ऑ,स्ट्रे,लि,या,ई
ka,la,maa	क,ल,मा
bha,r,maa,ye	भ,र,मा,ए
ju,noo	जु,नूँ
sa,ga,tha,n	सं,ग,ठ,न
me,mo,ri,ya,la	मे,मो,रि,य,ल
u,thaa,ye	उ,ठा,ए
ni,ka,lo,nge	नि,क,लो,गे
bha,ga,vaa,n	भ,ग,वा,न
bha,ga,va,n	भ,ग,व,न
be,pa,r,daa	बे,प,र,दा
aa,di,vaa,si	आ,दि,वा,सी
ji,yuu	जि,यूँ
bhaa,ga,va,ta	भा,ग,व,त
to,ha,faa	तो,ह,फ़ा
n,za,de,ye,ki	न,ज़,दे,ए,की
jaa,goo	जा,गूँ
da,ha,kaa	द,ह,का
da,ha,ke	द,ह,के
su,noo	सु,नूँ
kaa,rya,kra,ma	का,र्य,क्र,म
du,sa,ron	दू,स,रों
su,nda,raa,n,nda	सु,न्द,रा,न,न्द
a,kha,baa,r	अ,ख,बा,र
ni,bhaa,o,gi	नि,भा,ओ,गी
bu,haa,ru	बु,हा,रूँ
ni,bhaa,o,nge	नि,भा,ओ,गे
mu,sa,kaa,n	मु,स,का,न
maa,n,ne	मा,न,ने
sa,mbha,la,ti	स,म्भ,ल,ती
u,thaa,i,ye	उ,ठा,इ,ये
sa,mbha,la,taa	स,म्भ,ल,ता
ru,tha,te	रू,ठ,ते
ka,la,ka,tte	क,ल,क,त्ते
ka,la,ka,tta	क,ल,क,त्ता
n,n	न,वाँ
a,fsaa,ne	अ,फ़्सा,ने
u,ma,ri,ya	उ,म,रि,या
baa,ri,n	बा,रि,याँ
so,cha,taa	सो,च,ता
be,ha,raa,ma,pu,r	बे,ह,रा,म,पु,र
be,r,haa,ma,pu,r	बे,र,हा,म,पु,र
raa,na,i,yaan	रा,ना,इ,यां
raa,na,yi,yaan	रा,ना,ई,यां
i,sa,kaa	इ,स,का
u,sa,me	उ,स,में
ha,sa,ke	हं,स,के
ha,sa,ke	हँ,स,के
u,ta,ri	उ,त,री
aa,kho,ye,n	आँ,खो,ए,न
u,ta,re	उ,त,रे
u,ta,raa	उ,त,रा
gha,ti,n	घा,टि,याँ
ki,sa,mi,sa	कि,स,मि,स
ye,ka,ju,ta	ए,क,जु,ट
di,la,ba,ron	दि,ल,ब,रों
bha,gaa,ye	भ,गा,एं
chaa,uu	चा,ऊ
pra,tye,ka	प्र,त्ये,क
ma,r,zi	म,र,ज़ी
da,r,jaa	द,र,जा
pa,rchha,i,yon	प,र्छा,इ,यों
ka,r,va,ta	क,र,व,ट
shaa,ya,da	शा,य,द
ye,va	ए,वं
aa,o,gi	आ,ओ,गी
ni,haa,ru	नि,हा,रूँ
jaa,o	जा,ओ
ba,da,li,n	ब,द,लि,याँ
da,r,taa	ड,र,ता
ghu,ta,ne	घु,ट,ने
bhaa,r,ti,ya	भा,र,ती,य
gi,r,taa	गि,र,ता
jaa,ye	जा,ए
ji,n,pe	जि,न,पे
kaa,hoo	का,हूँ
bu,laa,o	बु,ला,ओ
ka,sha,ti	क,श,ती
gaa,ye,gi	गा,ए,गी
ti,ta,li	ति,त,ली
la,da,ki,n	ल,ड़,कि,याँ
aa,i,na	आ,इ,ना
ma,gaa,o	मं,गा,ओ
gu,faa,o	गु,फा,ओ
di,ya	दि,या
du,ni,ya	दु,नि,या
i,dau,r	इं,दौ,र
jaa,haa	जा,हाँ
ja,haa	ज,हाँ
la,ha,raa,yi	ल,ह,रा,ई
ha,vaa,yon	ह,वा,ओं
phi,ru	फि,रुँ
phi,ru	फि,रूँ
sa,vi,chaa,r	स,द्,‍, ,वि,चा,र
le	ले,ह्रें
ba,r,saa,ye	ब,र,सा,एं
sa,ma,jhaa,yuu	स,म,झा,ऊं
pa,r,vaa,non	प,र,वा,नों
ji,sa,ke	जि,स,के
ji,sa,ki	जि,स,की
ji,sa,ke	जि,स,के
ji,sa,kaa	जि,स,का
gu,n,gu,na,ye	गु,न,गु,ना,यें
ta,na,va,poo,rna	त,ना,व,पू,र्ण
ta,r,sa,ti	त,र,स,ती
ta,r,sa,taa	त,र,स,ता
ta,qa,raa,r	त,क़,रा,र
ta,ka,raa,r	त,क,रा,र
jaa,yuu	जा,ऊं
sa,dhi,ta	स,म्बं,धि,त
ro,ka,te	रो,क,ते
ro,yuu,gi	रो,ऊं,गी
ha,ma,jo,li	ह,म,जो,ली
ba,da,suu,r,ta	ब,द,सू,र,त
poo,chha,lo	पू,छ,लो
aa,i,ye,gaa	आ,इ,ये,गा
ho,li,n	हो,लि,याँ
nge,nda,baa,jon	गे,न्द,बा,जों
pa,r,son	प,र,सों
pa,ndra,ha,vi	पं,द्र,ह,वीं
gu,zaa,ru	ग़ु,ज़ा,रूँ
gu,zaa,ru	गु,ज़ा,रूँ
a,re	अ,रे
chi,kha,taa	ची,ख,ता
saa,yi,ka,la	सा,ई,क,ल
gu,n,ha,gaa,r	गु,न,ह,गा,र
jhu,laa,o	झु,ला,ओ
sha,r,maa,yi	श,र,मा,ई
u,ja,daa	उ,ज,ड़ा
so,ni,ya	सो,नि,या
ba,dho,tta,ri	ब,ढ़ो,त्त,री
baa,da,shaa,ha	बा,द,शा,ह
fu,r,sa,ta	फ़ु,र,स,त
be,qa,raa,r	बे,क़,रा,र
ra,ga,r,ja,vaa	रँ,ग,र,ज,वा
bu,laa,n,gaa	बु,ला,ऊँ,गा
ba,dho,tta,ri	ब,ढ़ो,त्त,री
n,za,ron	न,ज़,रों
she,ha,na,yi	शे,ह,ना,ई
ma,ha,gaa,yi	म,हं,गा,ई
ma,cha,la,ti	म,च,ल,ती
ma,cha,la,taa	म,च,ल,ता
ma,cha,la,te	म,च,ल,ते
hoo	हूँ
hu,yi	हु,ईं
hu,yi	हु,ई
ba,da,la,ne	ब,द,ल,ने
ya,ma,raa,ja	य,म,रा,ज
gaa,te	गा,ते
pa,ha,re	प,ह,रे
pa,r,ba,ton	प,र,ब,तों
pa,r,baa,ton	प,र,बा,तों
u,pa,vaa,saa	उ,प,वा,सा
ga,va	गाँ,व
u,n,su,ne	उ,न,सु,ने
raa,sa,te	रा,स,ते
raa,sa,taa	रा,स,ता
a,thaa,r,ha	अ,ठा,र,ह
yi,ya,ve	छ्चा,ई,य,वे
kvaa,ba	ख़्वा,ब
bai,ri,n	बै,रि,याँ
u,kha,daa	उ,ख,ड़ा
ma,ha,r,baa,ni	म,ह,र,बा,नी
me,ha,r,baa,ni	मे,ह,र,बा,नी
yi,da,u,la,phi,tta,r	ई,द,उ,ल,फि,त्त,र
pa,r,daa	प,र,दा
sa,ta,r,pu,r	स,त,र,पु,र
chho,ka,ri	छो,क,री
la,daa,o,nge	ल,ड़ा,ओ,गे
laa,ye,nge	ला,एं,गे
daa,ya,re,cto	डा,य,रे,क्ट
jhu,kaa,ye,nge	झु,का,एं,गे
shaa,ya,ri	शा,य,री
lo,ka,sa,bhaa	लो,क,स,भा
	c,a,n,n,o,t, ,u,n,d,e,r,s,t,a,n,d
sa,tta	स,त्ता
du,aa,ye	दु,आ,एं
ndi,ti,ye,cha	डी,टी,ए,च
bi,chhaa,n	बि,छा,ऊँ
bhi,laa,yi	भि,ला,ई
cha,hoo	च,हूँ
li,ye	लि,ए
ye,la,aa,i,si	ए,ल,आ,इ,सी
sa,ma,jhu	स,म,झूँ
la,gaa,n,gi	ल,गा,ऊँ,गी
ha,saa,ye,gi	हँ,सा,ए,गी
a,daa,ye	अ,दा,एं
ma,n,cha,laa	म,न,च,ला
pra,stu,ta	प्र,स्तु,त
aa,i	आ,इं
aa,yi	आ,ईं
la,ha,raa,ye	ल,ह,रा,ये
la,ha,raa,ye	ल,ह,रा,ए
ri,sha,tein	रि,श,तें
a,ju,ma,n	अं,जु,म,न
aa,i,sa	आ,इ,स
u,pa,kaa,r	उ,प,का,र
ba,ha,ka,taa	ब,ह,क,ता
ti,sa,ri	ती,स,री
ti,sa,re	ती,स,रे
ti,sa,raa	ती,स,रा
yi,da,u,la,phi,tta,r	ई,द,उ,ल,फि,त्त,र
sha,r,maa,ye,gi	श,र,मा,ए,गी
ta,ma,nna,ye	त,म,न्ना,एं
ye,ka,ju,ta	ए,क,जु,ट
su,n,saa,n	सु,न,सा,न
i,n,saa,n	इ,न,सा,न
ro,o,nge	रो,ओ,गे
chhu,paa,n,gi	छु,पा,ऊँ,गी
chhu,paa,yuu,gi	छु,पा,ऊं,गी
aa,i,ta,baa,r	आ,इ,त,बा,र
phi,la,haa,la	फि,ल,हा,ल
jha,r,non	झ,र,नों
ka,r,te	क,र,ते
ka,r,taa	क,र,ता
ghoo,ma,te	घू,म,ते
aa,na,da	आ,नं,द
ju,daa,yi	जु,दा,ई
ka,la,ka,tta	क,ल,क,त्ता
pa,la	प,ल,च्छीं
pa,la,chhi,n	प,ल,छि,न
jaa,du,ga,r,ni	जा,दू,ग,र,नी
den,nge	दें,गे
ru,sa,vaa,yi	रु,स,वा,ई
da,ga,ma,gaa,ye	ड,ग,म,गा,ये
mu,jhe	मु,झे
me,ha,r,baa,ni	मे,ह,र,बा,नी
vaa,pa,si	वा,प,सी
pai,ta,re,baa,ji	पैं,त,रे,बा,जी
ba,ha,ru,pi,ya	ब,ह,रू,पि,या
ka,li,n	क,लि,याँ
kaa,li,n	का,लि,याँ
kaa,li,ya	का,लि,या
ne,taa,yon	ने,ता,ओं
mo,sko	मॉ,स्को
ja,laa,ye	ज,ला,ए
pu,raa,o	पु,रा,ओ
aa,sa,maa,n	आ,स,मा,न
ja,laa,yi	ज,ला,ई
ja,laa,i	ज,ला,इ
ja,laa,o	ज,ला,ओ
du,haa,yi	दु,हा,ई
bi,taa,ye	बि,ता,ये
pa,r,jaa	प,र,जा
sa,ha,kaa,ri,taa	स,ह,का,रि,ता
sa,haa,kaa,ri,taa	स,हा,का,रि,ता
tha,ma,ke	था,म,के
aa,i,ye,n,ye,fa,aa,i	आ,इ,ए,न,ए,फ,आ,इ
ba,chaa,ye	ब,चा,ये
ba,chaa,ye	ब,चा,ए
ba,chaa,yi	ब,चा,ई
pu,r,vaa,yi	पु,र,वा,ई
mi,la,vaa,ya	मि,ल,वा,या
ba,ni,ye	ब,नि,ए
na	ना
n	न
n,yi	न,ई
n,hin	न,हीं
na	ना
pi,chha,le	पि,छ,ले
khu,sha,haa,li	खु,श,हा,ली
	ड्रॉ
i,n,kaa,r	इ,न,का,र
bu,jhaa,yi	बु,झा,ई
so,cha,na	सो,च,ना
a,ba	अ,ब
sa,jaa,yuu,gi	स,जा,ऊं,गी
aa,ya,si	आ,या,सी
su,r,maa,yi	सु,र,मा,ई
maa	मा
maa	माँ
maa,o	मा,ओ
maa	माँ
maa,yi	मा,ई
maa,ya	मा,य
maa,i	मा,इ
maa,ye	मा,ए
jhuu,ma,taa	झू,म,ता
chi,taa	चि,ता
pa,r,chhaa,yi	प,र,छा,ई
a,pne	अ,प्ने
se,ha,raa,va	से,ह,रा,व
thu,ka,raa,ye,gi	ठु,क,रा,ए,गी
bu,laa,n	बु,ला,ऊँ
paa,yuu,gaa	पा,ऊं,गा
bu,laa,ye	बु,ला,ए
bu,laa,o	बु,ला,ओ
da,r,da,vaa	द,र,द,वा
zi,da,gaa,ni	ज़िं,द,गा,नी
khaa,sa,ka,r	खा,स,क,र
sa,r,kaa,yuu,gaa	स,र,का,ऊं,गा
mu,jha,me	मु,झ,मे
daa,la,ne	डा,ल,ने
mu,sa,kaa,ye,gi	मु,स,का,ए,गी
bi,kha,raa	बि,ख,रा
bi,kha,re	बि,ख,रे
bi,kha,ri	बि,ख,री
ka,r,va,te	क,र,व,टें
chhu,yi	छु,ई
a,la,be,li	अ,ल,बे,ली
ko,la,kaa,ta	को,ल,का,त
ko,la,kaa,taa	को,ल,का,ता
a,la,be,laa	अ,ल,बे,ला
a,la,be,le	अ,ल,बे,ले
cha,ma,ka,n	च,म,क,न
cha,ma,kaa	च,म,का
jhuu,ma,ka,r	झू,म,क,र
gha,taa,yon	घ,टा,ओं
du,lha,ni,ya	दु,ल्ह,नि,या
da,r,vaa,zon	द,र,वा,ज़ों
du,la,ha,ni,ya	दु,ल,ह,नि,या
za,ha,r	ज़,ह,र
si,khaa,yi	सि,खा,ई
aa,di,vaa,si,yon	आ,दि,वा,सि,यों
laa,n,gaa	ला,ऊँ,गा
pa,hu,chaa,ye,gi	प,हुँ,चा,ए,गी
a,r,bon	अ,र,बों
ka,ta,taa	क,ट,ता
do,ha,raa,ne	दो,ह,रा,ने
di,kha,laa,ye,nge	दि,ख,ला,एं,गे
di,kha,laa,ye,gi	दि,ख,ला,एं,गी
ja,ga,ma,gaa,ti	ज,ग,म,गा,ती
ta,da,paa,ne,vaa,le	त,ड़,पा,ने,वा,ले
gaa,yon	गा,ओं
ba,gi,n	ब,गि,याँ
ba,gi,ya	ब,गि,या
khe,la,te	खे,ल,ते
khe,la,taa	खे,ल,ता
su,vi,dhaa,yon	सु,वि,धा,ओं
khe,la,ti	खे,ल,ती
bi,ja,li	बि,ज,ली
jaa,yuu	जा,ऊं
ma,r,haa,le	म,र,हा,ले
go,pi,n	गो,पि,याँ
a,lha,da,pa,n	अ,ल्ह,ड़,प,न
ta,da,pa,na	त,ड़,प,ना
gaa,ri,n	गा,रि,याँ
a,ba,laa	अ,ब,ला
a,ma,ro	अ,म,रो
aa,kha,ri	आ,ख,री
la,fa,daa	ल,फ़,ड़ा
la,fa,de	ल,फ़,ड़े
cha,ma,ki,laa	च,म,की,ला
cha,ma,ki,le	च,म,की,ले
cha,ma,ki,le	च,म,की,लें
ka,ro,da	क,रो,ड़
ka,ro,da	क,रो,ड़
jaa,goo	जा,गूँ
ka,ha,na	क,ह,ना
su,la,jhaa,ye	सु,ल,झा,ए
bi,chhaa,ye	बि,छा,ये
paa,la,n,haa,re	पा,ल,न,हा,रे
paa,la,n,haa,raa	पा,ल,न,हा,रा
n,nda,laa,la	न,न्द,ला,ल
pi,te	पी,ते
raa,ha,tein	रा,ह,तें
ba,dho,tta,ri	ब,ढ़ो,त्त,री
ba,ja,ne	ब,ज,ने
bi,sa,vi	बी,स,वीं
sa,ma,jhu	स,म,झूँ
pa,kaa,ye	प,का,एं
aa,jaa,ye	आ,जा,ए
mu,sku,raa	मु,स्कु,रा
ba,da,raa	ब,द,रा
bha,va,saa,ga,r	भ,व,सा,ग,र
sa,ha,te	स,ह,ते
sa,ha,taa	स,ह,ता
gha,ba,raa,yi	घ,ब,रा,ई
sa,ha,ti	स,ह,ती
ta,ka,ni,kon	त,क,नी,कों
pyaa,saa	प्या,सा
thu,ka,raa,ye	ठु,क,रा,एं
i,zza,ta,daa,ron	इ,ज़्ज़,त,दा,रों
mu,kta	मु,क्ता
mu,sku,raa,ye,gi	मु,स्कु,रा,ए,गि
bhu,laa,yuu	भु,ला,ऊं
jhi,la,mi,laa,ye,nge	झि,ल,मि,ला,एं,गे
ma,ha,gaa,yi	म,हं,गा,ई
chu,n,vaa,n	चु,न,वा,ऊँ
bi,ga,daa	बि,ग,ड़ा
bi,ga,di	बि,ग,ड़ी
bi,ga,de	बि,ग,ड़े
u,mmi,da,vaa,r	उ,म्मी,द,वा,र
ma,r,ti	म,र,ती
gu,ru,bhaa,yi	गु,रु,भा,ई
aa,yi,aa,yi,ye,ma	आ,ई,आ,ई,ए,म
baa,ta,chi,ta	बा,त,ची,त
cha,ka,na	च,क,ना
pi,ti	पी,टी
ba,ta,laa,n	ब,त,ला,ऊँ
ne,ta,va,ga	ने,ट,व,र्किं,ग
ku,cha,laa	कु,च,ला
i,kaa,yi,yon	इ,का,ई,यों
i,kaa,i,yon	इ,का,इ,यों
u,lle,kha,ni,ya	उ,ल्ले,ख,नी,य
ji,sa,se	जि,स,से
gyaa,raa	ग्या,रा
sa,r,kaa,ri	स,र,का,री
du,ri,n	दू,रि,याँ
sa,r,kaa,ron	स,र,का,रों
raa,ja,ni,ti,ka	रा,ज,नी,ति,क
ja,la,taa	ज,ल,ता
ja,la,te	ज,ल,ते
ja,la,ti	ज,ल,ती
za,rra	ज़,र्रा
hai	हैं
pa,r,va,ta	प,र,व,त
pa,r,va,r	प,र,व,र
baa,va,ri	बा,व,री
chha,la,ki	छ,ल,की
sa,n,maa,n	स,न,मा,न
cha,la,ke	च,ल,के
chha,la,ke	छ,ल,के
dha,da,ka,te	ध,ड़,क,ते
ba,dha,ne	ब,ढ़,ने
a,ka,don	आं,क,ड़ों
sa,ja,ni	स,ज,नी
sa,ja,ne	स,ज,ने
sa,ja,n	स,ज,न
saa,ja,na	सा,ज,ना
saa,ja,n	सा,ज,न
sa,ja,na	स,ज,ना
jaa	जा,वूँ
bai,n	बै,याँ
ni,r,gu,n	नि,र,गु,न
ye,shi,ya	ए,शि,या
du,vaa,ye	दु,वा,एँ
ki,sa,ne	कि,स,ने
me,ha,r,baa,ni	मे,ह,र,बा,नी
a,ta,ke	अ,ट,के
di,la,vaa,le	दि,ल,वा,ले
ye,va	ए,वं
ha,ma,sa,fa,r	ह,म,स,फ़,र
ma,jha,dhaa,r	म,झ,धा,र
ka,ru	क,रुँ
ka,ru	क,रूँ
cha,luu	च,लूँ
ru,laa,ye,gi	रु,ला,ए,गी
ha,r,ka,ta	ह,र,क,त
ha,ma,jo,li	ह,म,जो,ली
pa,r,chhaa,i,yon	प,र,छा,इ,यों
bon,saa,yi	बों,सा,ई
u,tha,taa	उ,ठ,ता
ma,ja,boo,ri,n	म,ज,बू,रि,याँ
ka,ma,si,ni	क,म,सि,नी
ba,la,khaa,ke	ब,ल,खा,के
a,ma,ro	अ,म,रो
	c,a,n,n,o,t, ,u,n,d,e,r,s,t,a,n,d
a,r,maa,non	अ,र,मा,नों
ja,ga,ma,gaa,ne	ज,ग,म,गा,ने
kaa,mo,shi,n	ख़ा,मो,शि,याँ
di,shaa,ye	दि,शा,एं
aa,sa,maa	आ,स,माँ
di,kha,laa,n	दि,ख,ला,ऊँ
ba,taa,ye	ब,ता,एं
a,n,su,ni	अ,न,सु,नी
a,n,suu,ni	अ,न,सू,नी
pa,r,de,si,ya	प,र,दे,सि,या
a,n,su,na	अ,न,सु,ना
aa,za,maa,o,nge	आ,ज़,मा,ओ,गे
ru,laa,ye,gi	रु,ला,एं,गी
chu,r,ry	चु,र,र्
ru,laa,ye,nge	रु,ला,एं,गे
mu,shki,la	मु,श्कि,ल
ma,ha,kaa,o,nge	म,ह,का,ओ,गे
si,haa,sa,n	सिं,हा,स,न
ji,daa,yi	जि,दा,ई
cha,dhaa,n,gi	च,ढ़ा,ऊँ,गी
ja,n,mon	ज,न,मों
too	तू,फ़ाँ
r,fi	र,फ़ी,क़ो
ka,la,ju,ga	क,ल,जु,ग
bhi	भी
ji,sa,ki	जि,स,की
ji,sa,kaa	जि,स,का
1	1,9
baa,yi	बा,ई
daa,luu	डा,लूँ
saa,i,da	सा,इ,ड
khya,laa,ton	ख्या,ला,तों
too	तू,फ़ाँ
ha,sa,ne,vaa	ह,स,ने,वा,लोँ
hi,mma,ta,vaa,laa	हि,म्म,त,वा,ला
ba,da,gu,maa	ब,द,गु,मा
so,la,ha,vi	सो,ल,ह,वीं
sa,ma,jhe,gi	स,म,झे,गी
be,i,khti,ya,r	बे,इ,ख़्ति,या,र
ji,nda,vaa,daa	जि,न्द,वा,ड़ा
bu,laa	बु,ला,वूँ
bha,ta,kaa	भ,ट,का
bha,ta,ke	भ,ट,के
chaa,o	चा,ओ
paa,n	पा,ऊँ
ha,ma,lon	ह,म,लों
du,ri,n	दू,रि,याँ
aa,za,maa,o	आ,ज़,मा,ओ
kha,n,kaa,ti	ख,न,का,ती
la,ha,raa,yuu,gi	ल,ह,रा,ऊं,गी
gha,n,shyaa,ma	घ,न,श्या,म
do,luu	डो,लूँ
ba,jaa,ye,gaa	ब,जा,ए,गा
ma,na,o	म,ना,ओ
ma,na,yi	म,ना,ई
ma,na,ye	म,ना,ए
do,sau	2,0,4
pa,ha,n,ke	प,ह,न,के
ka,da,mon	क,द,मों
gha,ba,raa,na	घ,ब,रा,ना
fi,r,dau,sa	फ़ि,र,दौ,स
ndi,ye,n,ye	डी,ए,न,ए
bha,r,ne,kaa	भ,र,ने,का
lu,bhaa,ye	लु,भा,ए
a,mbu,aa	अ,म्बु,आ
de,khe	दे,खे
da,r,ne	ड,र,ने
ru,laa,n,gaa	रु,ला,ऊँ,गा
a,r,maa	अ,र,मां
a,r,maa,n	अ,र,मा,न
laa,n,gaa	ला,ऊँ,गा
sha,ha,zaa,don	श,ह,ज़ा,दों
vi,raa	वी,राँ
	द्ल
di,ye	दि,ए
di,ya	दि,या
li,khaa,o	लि,खा,ओ
su,noo	सु,नूँ
di,la,n,shi	दि,ल,न,शी
laa,o,sa	ला,ओ,स
pi,ta,ti	पी,ट,ती
ga,ha,raa	ग,ह,रा
vaa,i,za	वा,इ,ज़
daa,i,ga	डा,इं,ग
a,r,maa,no	अ,र,मा,नो
a,r,maa,non	अ,र,मा,नों
ye,ve,ri,ba,ndi	ए,वे,रि,ब,डी
ba,haa,ye	ब,हा,ए
ri,ya,lti	रि,य,ल्टी
ma,laa,i	म,ला,इ
r,ti,n	र,ति,याँ
jaa,ye,gaa	जा,ये,गा
i,la,zaa,ma	इ,ल,ज़ा,म
n,vi	न,वीं
khu,da,ku,shi	खु,द,कु,शी
ba,n,vaa,ye	ब,न,वा,ये
dvi,ti,ya	द्वि,ती,य
sha,r,maa,o,gi	श,र,मा,ओ,गी
ye,va	ए,वं
maa	माँ
jhaa,bu,aa	झा,बु,आ
ju,baa,ya,daa	जु,बा,य,दा
di,la,ka,sha	दि,ल,क,श
ta,ka,te	त,क,ते
ta,ka,ti	त,क,ती
r,ha,te	र,ह,ते
jaa,ye,nge	जा,यें,गे
ba,rbaa,da	ब,र्बा,द
pa,ta,li	प,त,ली
r,ma,jaa,ni	र,म,जा,नी
dha,n,vaa,non	ध,न,वा,नों
gaa,n,gi	गा,ऊँ,गी
di,kha,laa,yi	दि,ख,ला,ई
ki,ji,ye	की,जि,ए
a,maa	अ,माँ
ni,shaa	नि,शाँ
ma,ja,boo,ri,yaan	म,ज,बू,रि,यां
gha,ba,raa,yi	घ,ब,रा,ई
chho,doo	छो,ड़ूँ
kaa,r,n	का,र,वाँ
gu,za,ren,gi	गु,ज़,रें,गी
gu,ja,ren,nge	गु,ज,रें,गे
paa,n,gaa	पा,ऊँ,गा
paa,yuu,gaa	पा,ऊं,गा
sa,ha,laa,na	स,ह,ला,ना
dhya,ve	ध्या,वे
n,ga,r,paa,li,kaa	न,ग,र,पा,लि,का
gaa,ye	गा,येँ
gaa,ye	गा,एँ
chhu,paa,yi	छु,पा,ई
chhu,paa,o	छु,पा,ओ
phu,la,jha,di,yon	फु,ल,झ,ड़ि,यों
	ख़ूँ
ni,cho,da,ti	नि,चो,ड़,ती
paa,pa,ki	पा,प,की
pa,ha,na,ye	प,ह,ना,एँ
la,gaa,ye,gi	ल,गा,ए,गी
ju,ga,nuun	जु,ग,नूं
sa,ma,ya,ke	स,म,य,के
ha,r,ka,tein	ह,र,क,तें
pra,saa,r,n	प्र,सा,र,ण
a,ka,don	आं,क,ड़ों
ye,ka,da	ए,क,ड़
i,mti,ya,ja	इ,म्ति,या,ज
ja,gaa,yuu,gaa	ज,गा,ऊं,गा
pa,dhaa,yi	प,ढ़ा,ई
pa,dhaa,yi	प,ढा,ई
la,ga,taa	ल,ग,ता
a,pi,tu	अ,पि,तु
su,la,ga,ne	सु,ल,ग,ने
paa	पा
shri	श्री
paa,yi	पा,ई
paa	पा
paa,n	पा,ऊँ
ja,ya,kaa,r	ज,य,का,र
du,n,de	दू,न,दे
mu,jha,saa	मु,झ,सा
bo,ta,la	बो,त,ल
laa,n,gi	ला,ऊँ,गी
pa,rba,ta	प,र्ब,त
pa,la,ne	प,ल,ने
mi,khaa,i,la	मि,खा,इ,ल
pa,la,na	प,ल,ना
sa,ma,jhaa,n	स,म,झा,ऊँ
pa,raa,yi	प,रा,ई
praa,n	प्रा,ण
da,ha,li,jon	द,ह,ली,जों
jaa,u,gaa	जा,उं,गा
jaa,yuu,gaa	जा,ऊं,गा
jaa,n,gaa	जा,ऊँ,गा
jaa,n,gi	जा,ऊँ,गी
jaa,u,gi	जा,उँ,गी
jaa,yuu,gi	जा,ऊं,गी
a,daa,ye	अ,दा,एँ
shi,ka,vaa	शि,क,वा
ba,chaa,i,ye	ब,चा,इ,ये
shaa,ya,r	शा,य,र
ja,ga,na	ज,ग,ना
jaa,ga,na	जा,ग,ना
jaa,ga,ne	जा,ग,ने
raa,ste	रा,स्ते
raa,ston	रा,स्तों
r,ha,ka,r	र,ह,क,र
ji,ta,na	जि,त,ना
ji,ta,ne	जी,त,ने
ji,ta,ne	जि,त,ने
too	तू,फ़ाँ
mu,jha,pa,r	मु,झ,प,र
ha,vaa,yon	ह,वा,ओं
ha,vaa,o,n	ह,वा,ओ,न
gha,ga,ri,ya	घा,ग,रि,या
si,ma,r,n	सि,म,र,न
ma,de,li,n,vaa,le	मं,डे,ली,न,वा,ले
ki,zaa,yon	ख़ि,ज़ा,ओं
pa,r,chhaa,yi	प,र,छा,ई
de,kha,na	दे,ख,ना
fa,r,maa,o,nge	फ़,र,मा,ओ,गे
i,ka,raa,r	इ,क,रा,र
daa,ru	डा,रूँ
be,ri,n	बे,रि,याँ
ba,dho,tta,ri	ब,ढ़ो,त्त,री
sa,r,ha,den	स,र,ह,दें
ha,me	ह,में
ji,ha,pu,r	जि,ह,पु,र
de,va,taa	दे,व,ता
khuu,bi,n	खू,बि,याँ
ye,bi,ye,n	ए,बी,ए,न
tu,ma,ha,re	तु,म,ह,रे
da,ru	ड,रूँ
chha,la,ke	छ,ल,कें
va,ha,shi	व,ह,शी
mu,aa,ma,laa	मु,आ,म,ला
ba,r,baa,da	ब,र,बा,द
khu,shk	खु,श्क
chaa,da,ni	चाँ,द,नी
chaa,da,ni	चां,द,नी
maa,ru	मा,रूँ
bi,maa,ri,n	बी,मा,रि,याँ
jaa,ye,gi	जा,ए,गी
chhi,ha,tta,r	छि,ह,त्त,र
su,r,ji,ta	सु,र,जी,त
va,llaa	व,ल्ला
chuu,ma,te	चू,म,ते
chuu,ma,taa	चू,म,ता
kha,ta,re	ख,त,रे
chuu,ma,ti	चू,म,ती
ma,ha,r,baa,ni	म,ह,र,बा,नी
me,ha,r,baa,ni	मे,ह,र,बा,नी
n,r,si,mhaa	न,र,सि,म्हा
la,la,chaa,n	ल,ल,चा,ऊँ
bi,ja,li,yaan	बि,ज,लि,यां
ye,ka	ए,क
i,sa	इ,स
sa,vaa,r,ne	सँ,वा,र,ने
ka,sa,r,ta	क,स,र,त
saa,jha,ke	सा,झ,के
dhoo,dhoo	ढूँ,ढूँ
da,ga,ma,gaa	ड,ग,म,गा
ye,sa,ye,cha,pi,ye,sa	ए,स,ए,च,पी,ए,स
a,r,ba	अ,र,ब
pa,r,chhaa,yi	प,र,छा,ईं
ba,dho,tta,ri	ब,ढ़ो,त्त,री
ma,chaa,n,gi	म,चा,ऊँ,गी
bi,ga,da,ti	बि,ग,ड़,ती
ta,da,poo	त,ड़,पूँ
sa,vaa,ru	सँ,वा,रूँ
da,ru	ड,रूँ
maa,n,te	मा,न,ते
maa,n,taa	मा,न,ता
ta,da,paa,o	त,ड़,पा,ओ
jo,di,n	जो,ड़ि,याँ
ka,da,mon	क,द,मों
qa,da,mon	क़,द,मों
ti,sa,raa	ती,स,रा
kaa,ma,ya,ba	का,म,या,ब
baa,zu,yon	बा,ज़ु,ओं
ma,r,hu,ma	म,र,हू,म
r,hoo	र,हूँ
pa,ha,chaa,ne	प,ह,चा,ने
ta,r,faa	त,र,फ़ा
gaa,yi,ye	गा,ई,ये
la,la,chaa,n,gaa	ल,ल,चा,ऊँ,गा
mi,la,taa	मि,ल,ता
ba,r,ru,ye	ब,र,रु,ए
sa,daa,ye	स,दा,एं
ro,ki,ye	रो,कि,ए
aa,ga,vaa,ni	आ,ग,वा,नी
na,te	ना,ते
su,ha,ma	सु,ह,म
be,ha,non	बे,ह,नों
bhaa,ja,paa	भा,ज,पा
sa,r,di	स,र,दी
ma,ta,vaa,le	म,त,वा,ले
ha,msa,fa,r	ह,म्स,फ़,र
su,na,ye,gi	सु,ना,एँ,गी
ba,sa,taa	ब,स,ता
i,ta,jaa,r	इं,त,जा,र
su,na,ye,nge	सु,ना,एं,गे
su,na,ye,nge	सु,ना,एँ,गे
ba,sa,ti	ब,स,ती
hoo	हूँ
hai	हैं
ndi,ka,ri	डी,क,री
sa,da,kon	स,ड़,कों
a,ha,ma,daa,baa,da	अ,ह,म,दा,बा,द
bi,ta,te	बी,त,ते
praa,rtha,na	प्रा,र्थ,ना
ba,ta,laa	ब,त,ला
ba,ha,laa,na	ब,ह,ला,ना
du,lha,ni,ya	दु,ल्ह,नि,या
saa,yi	सा,ई
saa,ye	सा,ए
khi,la,tin	खि,ल,तीं
ba,la,maa	ब,ल,मा
aa,sa,maa,non	आ,स,मा,नों
aa,sa,maa,ni	आ,स,मा,नी
si,khaa,yi	सि,खा,ई
pa,ha,ne	प,ह,ने
pa,ha,na	प,ह,ना
ha,saa,o	हँ,सा,ओ
pa,ha,no	प,ह,नो
ma,r,na	म,र,ना
kho,ye	खो,ए
u,ta,ren,nge	उ,त,रें,गे
ma,la,ne	म,ल,ने
ma,ta,vaa,laa	म,त,वा,ला
ma,ta,vaa,le	म,त,वा,ले
ma,ta,vaa,li	म,त,वा,ली
jaa,o,gi	जा,ओ,गी
do,sau,sau,6	2,0,0,6
ma,ha,r,baa	म,ह,र,बाँ
me,ha,rbaan	मे,ह,र्बां
me,ha,r,baa	मे,ह,र,बाँ
ma,hi,ne	म,ही,ने
cha,la,ti	च,ल,ती
za,rdi,n	ज़,र्दि,याँ
ja,ga,ma,gaa	ज,ग,म,गा
aa,a,ye	आ,अ,ये
i,ga,li,staa,n	इं,ग,लि,स्ता,न
r,chaa,ye	र,चा,एं
khu,la,ka,r	खु,ल,क,र
tu,jhe	तु,झे
me,ri,n	मे,रि,याँ
jhuu,ma,na	झू,म,ना
pra,dhaa,n,ma,tri	प्र,धा,न,मं,त्री
ga,r,di,sha	ग,र,दि,श
la,ga,taa	ल,ग,ता
la,ga,te	ल,ग,ते
la,ga,ti	ल,ग,ति
la,ga,ti	ल,ग,ती
da	द,र्दाँ
ba,ha,laa,o	ब,ह,ला,ओ
maa,ye,ri	मा,ए,री
ba,dhaa,i,ye	ब,ढ़ा,इ,ये
ka,ha,laa,o,nge	क,ह,ला,ओ,गे
ka,ha,na	क,ह,ना
ka,ha,ne	क,ह,ने
ka,ha,ni	क,ह,नी
cha,ta,kaa,ro	च,ट,का,रो
sha,raa,ba,kaa,ne	श,रा,ब,ख़ा,ने
ta,lm,laa,ye	त,ल्म,ला,ये
ma,la,ma,la	म,ल,म,ल
tu,ma,pe	तु,म,पे
pa,raa,yi	प,रा,ई
ye,bi,ye,n	ए,बी,ए,न
ye,bi,ye,n	ए,बी,ए,न
ba,ha,laa,ye	ब,ह,ला,ए
ha,vaa,yon	ह,वा,ओं
a,khi,ya	अ,खि,या
a,khi,n	अ,खि,याँ
be,pa,r,vaa,ha	बे,प,र,वा,ह
u,tha,ke	उ,ठ,के
ja,ya,gho,sha	ज,य,घो,ष
ni,kha,r,taa	नि,ख,र,ता
ji,sa,kaa	जि,स,का
la,ha,raa,yi	ल,ह,रा,ई
vaa	वा
n	वाँ
ha,r,pa,la	ह,र,प,ल
ha,sa,te	हं,स,ते
ha,sa,te	हँ,स,ते
ha,sa,taa	हँ,स,ता
ha,sa,ti	हँ,स,ती
aa,i,ta,baa,r	आ,इ,त,बा,र
sa,ma,jhaa,o	स,म,झा,ओ
da,r,mi,yaan	द,र,मि,यां
da,rmi,n	द,र्मि,याँ
lo,ve	लो,वे
ta,sa,vi,ron	त,स,वी,रों
chaa,ha,ne	चा,ह,ने
chaa,ha,na	चा,ह,ना
thu,ka,raa,ke	ठु,क,रा,के
raa,ma,cha,ndra,ki	रा,म,चं,द्र,की
de,ne	दे,ने
chhu,paa,n	छु,पा,ऊँ
ga,n	ग,द्दि,याँ
ja,la,taa	ज,ल,ता
ba,saa,ye	ब,सा,एं
ba,ti,n	ब,ति,याँ
ba,ti,ya	ब,ति,या
maa,i,sa	मा,इ,स
maa,yi	मा,ई
ja,gaa,i,ye	ज,गा,इ,ये
vi,aa,r,ye,sa	वी,आ,र,ए,स
cha,ya,n	च,य,न
me,ha,fi,la	मे,ह,फ़ि,ल
ma,ha,fi,la	म,ह,फ़ि,ल
ye,sa	ए,स
ku,shi,n	ख़ु,शि,याँ
khu,shi,n	खु,शि,याँ
baa,da,shaa,ho	बा,द,शा,हों
ba,chpa,n	ब,च्प,न
ta,n,haa,yi,n	त,न,हा,ई,याँ
ta,n,haa,yi,yaan	त,न,हा,ई,यां
bhaa,va,na,o	भा,व,ना,ओ
sa,da,bu,ddh	स,द,बु,द्ध
jaa,o,nge	जा,ओ,गे
ka,raan,nge	क,रां,गे
cha,ma,kaa,n	च,म,का,ऊँ
jaa,n,kaa,ri	जा,न,का,री
la,mhaa,ta	ल,म्हा,त
a,la,kon	अ,ल,कों
jaa,n,ke	जा,न,के
chhu,pa,taa	छु,प,ता
paa,von	पाँ,वों
paa,yon	पा,ओं
paa,n	पा,ऊँ
koo	कूँ
u,ga,li,yon	उं,ग,लि,यों
u,ga,li,yon	उँ,ग,लि,यों
kaa,mo,shi,n	ख़ा,मो,शि,याँ
khaa,mo,shi,n	खा,मो,शि,याँ
r,ta,laa,ma	र,त,ला,म
ta,da,paa,taa	त,ड़,पा,ता
ta,da,paa,te	त,ड़,पा,ते
ta,da,paa,ti	त,ड़,पा,ती
ta,da,paa,ti	ट,ड़,पा,ती
aa,pa,kaa	आ,प,का
bha,r,na	भ,र,ना
bha,r,ne	भ,र,ने
raa,staa	रा,स्ता
ja,ga,ma,gaa,ke	ज,ग,म,गा,के
khwaa,i,shen	ख्वा,इ,शें
va,faa,ye	व,फ़ा,एं
pi,ye	पि,ए
sha,r,maa,ya	श,र,मा,य
sha,r,maa,o	श,र,मा,ओ
sha,r,maa,yi	श,र,मा,ई
sha,rmaa,ye	श,र्मा,ए
bi,ndu,yon	बि,न्दु,ओं
ma,na,ye,gaa	म,ना,ए,गा
pa,ha,chaa,noo	प,ह,चा,नूँ
pi,laa,yuu	पि,ला,ऊं
daa,le	डा,ले
pa,ha,chaa,no	प,ह,चा,नो
pa,ha,chaa,ni	प,ह,चा,नी
ba,na,n,gaa	ब,ना,ऊँ,गा
pa,chha,taa,ye	प,छ,ता,ये
mu,aa,fi	मु,आ,फ़ी
n,ha,laa,o	न,ह,ला,ओ
ha,ma,pe	ह,म,पे
ti,ta,li	ति,त,ली
be,ga	बे,गाँ
a,ka,ba,r	अ,क,ब,र
ha,vaa,ye	ह,वा,एं
khu,shbu,yon	खु,श्बु,ओं
sa,r,taa,ja	स,र,ता,ज
ye,ka,ju,ta	ए,क,जु,ट
ye,ka,ju,ta	ए,क,जु,ट
mo,doo	मो,ड़ूँ
mu,ma,taa,za	मु,म,ता,ज़
de,va,taa	दे,व,ता
u,la,jhaa,o	उ,ल,झा,ओ
ma,da,ma,sta	म,द,म,स्त
aa,n,gaa	आ,ऊँ,गा
aa,yuu,gaa	आ,ऊं,गा
ha,r,da,ma	ह,र,द,म
aa,yuu,gi	आ,ऊं,गी
aa,n,gi	आ,ऊँ,गी
ye,n,aa,i,aa,i,ti	ए,न,आ,इ,आ,इ,टी
ye,n,aa,yi,aa,yi,ti	ए,न,आ,ई,आ,ई,टी
cha,dhaa,yuu,gaa	च,ढ़ा,ऊं,गा
la,ha,raa,o	ल,ह,रा,ओ
jyu	ज्यूँ
ma,ha,boo,baa	म,ह,बू,बा
r,kha,ne	र,ख,ने
do,ha,raa,ye	दो,ह,रा,एं
re,msa	रे,म्स
to,luu	तो,लूँ
pa,r,chhaa,yi	प,र,छा,ई
me,gha,du,ta	मे,घ,दू,त
khi,laa,yuu,gaa	खि,ला,ऊं,गा
jha,ga,de	झ,ग,ड़े
tu,ma,ri	तु,म,री
jha,ga,daa	झ,ग,ड़ा
pa,ka	प,क,डूँ
pa,ka,doo	प,क,ड़ूँ
haa,sha,r	हा,श,र
a,ka,don	आं,क,ड़ों
ba,saa,o,nge	ब,सा,ओ,गे
sha,r,maa,ye	श,र,मा,ये
ni,r,ba,la	नि,र,ब,ल
gu,li	गु,लि,स्ताँ
ba,n,si	ब,न,सी
sha,raa,r,ti	श,रा,र,ती
tu,ka,daa	टु,क,ड़ा
khu,sha,bu,yon	खु,श,बु,ओं
me,ha,r,baa,ni,n	मे,ह,र,बा,नि,याँ
ta,da,paa,ye,gaa	त,ड़,पा,ए,गा
raa,va	रा,व
sa,r,ha,don	स,र,ह,दों
raa,ya	रा,य
r,ha,na	र,ह,ना
re,haa,na	रे,हा,ना
r,ha,ne	र,ह,ने
thu,ka,raa,ye	ठु,क,रा,एं
kha,da,ke	ख,ड़,के
sa,maa,ye	स,मा,ए
sa,maa,o	स,मा,ओ
sa,maa	स,मा
sa,maa	स,माँ
sa,maa,yi	स,मा,ई
laa,i,ga	ला,इं,ग
gu,n,gu,na,n	गु,न,गु,ना,ऊँ
ma,ta,vaa,laa	म,त,वा,ला
sa,ka,taa	स,क,ता
sa,ka,te	स,क,ते
sa,ka,ta	स,क,त
sa,ka,te	स,क,ते
sa,ka,ti	स,क,ती
da,baa,ye	द,बा,ए
ba,dha,ne	बं,ध,ने
chhi,paa,o,nge	छि,पा,ओ,गे
ka,re	क,रे
ka,ren	क,रें
ma,n,vaa	म,न,वा
ka,re	क,रे
kaa,tu	का,टूँ
zi,ni,n	ज़ि,न्द्गा,नि,याँ
a,n,jaa,na	अ,न,जा,ना
a,n,jaa,ne	अ,न,जा,ने
bhu,laa,o,nge	भु,ला,ओ,गे
a,n,jaa,ni	अ,न,जा,नी
a,n,jaa,ne	अ,न,जा,ने
i,ta,r,praa,i,je,ja	इं,ट,र,प्रा,इ,जे,ज
tu,jha,me	तु,झ,में
ga,rma	ग,र्म
paa,ri,n	पा,रि,याँ
pa,ri,n	प,रि,याँ
sa,daa,ye	स,दा,एँ
sa,jaa,n,gaa	स,जा,ऊँ,गा
chaa,ha,ton	चा,ह,तों
ba,taa,yuu	ब,ता,ऊं
pa,r,chhaa,yi	प,र,छा,ई
aa,ma,ba,r	आ,म,ब,र
bha,ga,raa	भं,ग,रा
ka,la,shi	क,ल,शी
1,7,3	1,9,7,3
vaa,ya,n,tyaa,ne	वा,या,न,त्या,ने
la,da,kha,daa,ya	ल,ड़,ख,ड़ा,या
jha,ga,da,na	झ,ग,ड़,ना
r,sa,mon	र,स,मों
sa,jaa,ne	स,जा,ने
jon,ga,re	जों,ग,रे
cha,la,ti	च,ल,ती
cha,la,taa	च,ल,ता
cha,la,te	च,ल,ते
chha,la,te	छ,ल,ते
cha,la,ti	च,ल,ती
ja,n	ज,वाँ
gaa,o,nge	गा,ओ,गे
ma,r,gha,ta	म,र,घ,ट
sa,taa,o,nge	स,ता,ओ,गे
ta,ntri,kaa,yon	तं,त्रि,का,ओं
shaa,n,daa,r	शा,न,दा,र
r,ha,ti	र,ह,ती
pa,na,ha	प,ना,ह
i,rd,gi,rd	इ,र्द, ,गि,र्द
u,da,na	उ,ड़,ना
ki	ख़ि,त्ने
faa,sa,lon	फ़ा,स,लों
ka,li,n	क,लि,याँ
u,nhen	उ,न्हें
pa,ha,na,yu,gaa	प,ह,ना,यूं,गा
aa,n,gaa	आ,ऊँ,गा
aa,n,gi	आ,ऊँ,गी
1,7	1,9,4,7
mu,sa,kaa,o	मु,स,का,ओ
mu,sa,kaa,yi	मु,स,का,ई
baa,ye	बा,एँ
di,kha,laa,n,gaa	दि,ख,ला,ऊँ,गा
jaa,ye	जा,एं
tha,ppa,a	ठ,प्पा,अ
aa,shaa,yon	आ,शा,ओं
aa,gaa	आ,गा
sa,fa,la,taa,ye	स,फ,ल,ता,एँ
ba,r,chhaa	ब,र,छा
si,ma,ta,na	सि,म,ट,ना
si,ma,ta,ne	सि,म,ट,ने
ba,dha,taa	ब,ढ़,ता
ba,la,khaa,ti	ब,ल,खा,ती
sa,haa,ya,taa	स,हा,य,ता
aa,jaa,ye	आ,जा,एं
saa,va,n	सा,व,न
si,lvaa,n,gaa	सि,ल्वा,ऊँ,गा
i,mti,haa	इ,म्ति,हाँ
bhu,laa,o	भु,ला,ओ
se,vaa,ye	से,वा,एँ
a,fa,so,sa	अ,फ़,सो,स
a,fa,so,sa	अ,फ,सो,स
ja,ga,ma,gaa,ya	ज,ग,म,गा,या
ja,ga,ma,gaa,ye	ज,ग,म,गा,ये
ja,ga,ma,gaa,ye	ज,ग,म,गा,ए
aa,za,ma	आ,ज़,म
ba,taa	ब,ता
ma,jha,dhaa,r	म,झ,धा,र
la,goo	ल,गूँ
gu,la,gu,le	गु,ल,गु,ले
ka,shmi,r	क,श्मी,र
pi,gha,la,ti	पि,घ,ल,ती
pi,gha,la,te	पि,घ,ल,ते
pi,gha,la,taa	पि,घ,ल,ता
pa,ha,n,ke	प,ह,न,के
ga,va	गाँ,व
ta,da,paa,o,nge	त,ड़,पा,ओ,गे
poo	पू,जूँ
da,r,vaa,zon	द,र,वा,ज़ों
r,ha,ne	र,ह,ने
r,ha,na	र,ह,ना
bo,la,te	बो,ल,ते
bo,la,taa	बो,ल,ता
bo,la,ti	बो,ल,ती
a,dhi,kaa,ri,yon	अ,धि,का,रि,यों
ja,ya,va,rdha,ne	ज,य,व,र्ध,ने
u,n,ko	उ,न,को
ka,laa,yi	क,ला,ई
pa,ta,vaa,r	प,त,वा,र
dha,sa,ne	धं,स,ने
li,pa,ta,ne	लि,प,ट,ने
ju,baa,ya,daa	जु,बा,य,दा
bhaa,jaa,paa,yi	भा,जा,पा,ई
su,na,yuu	सु,ना,ऊं
su,na,n	सु,ना,ऊँ
te,re,n	ते,रे,याँ
jhuu,la,na	झू,ल,ना
aa,za,maa	आ,ज़,मा
i,ta,na	इ,त,ना
i,ta,ne	इ,त,ने
u,la,jha,n	उ,ल,झ,न
i,ta,na	इ,त,ना
i,ta,n	इ,त,न
u,la,jhaa	उ,ल,झा
ma,da,ho,shi	म,द,हो,शी
jha,ga,daa	झ,ग,ड़ा
a,dhya,ksha,taa	अ,ध्य,क्ष,ता
ga,ha,raa,i,yon	ग,ह,रा,इ,यों
ka,ta,raa,o	क,त,रा,ओ
ba,haa,ne	ब,हा,ने
a,la,saa,ye	अ,ल,सा,ये
gu,staa,khi,n	गु,स्ता,खि,याँ
khi,la,ti	खि,ल,ती
khi,la,taa	खि,ल,ता
khi,la,te	खि,ल,ते
sa,da,taa	स,द,ता
la,taa,yon	ल,ता,ओं
baa,yi	बा,ई
a,va,sa,ron	अ,व,स,रों
i,kaa,i,yon	इ,का,इ,यों
sa,r,ga,ma	स,र,ग,म
tu,jha,pe	तु,झ,पे
mu,skaa,ye	मु,स्का,एँ
su,ne	सु,ने
ma,chaa,ye	म,चा,ए
la,ha,raa,ya	ल,ह,रा,या
phi,r,ti	फि,र,ती
ma,chaa,o	म,चा,ओ
la,ha,raa,yi	ल,ह,रा,ई
le,ha,raa,yi	ले,ह,रा,यी
la,ha,raa,yin	ल,ह,रा,यीं
pu,r,vaa,yi	पु,र,वा,ई
shaa,ya,ri	शा,य,री
ba,r,saa,ka,r	ब,र,सा,क,र
hi,r,da,ya	हि,र,द,य
be,khya,li	बे,ख्या,ली
khu,sha,nu,maa	खु,श,नु,मा
jhuu,ma,te	झू,म,ते
jhuu,ma,taa	झू,म,ता
jhuu,ma,ti	झू,म,ती
i,sa	इ,स
pa,laa,ni,ma,kka,ma	प,ला,नि,म,क्क,म
la,ha,raa,yi	ल,ह,रा,ई
la,ha,raa,o	ल,ह,रा,ओ
la,ha,raa,ye	ल,ह,रा,ए
pa,ppi,n	प,प्पि,याँ
fi,zaa,yon	फ़ि,ज़ा,ओं
sa,haa,ya,taa	स,हा,य,ता
chaa,hi,ye	चा,हि,ए
mu,r,jhaa	मु,र,झा
di,la,vaa,lon	दि,ल,वा,लों
baa,i,kaa,rba	बा,इ,का,र्ब
gu,aa,laa	गु,आ,ला
n,ha,laa	न,ह,ला
ka,vi,yi,tri	क,वि,यि,त्री
jo,da,na	जो,ड़,ना
da,r,mi,n	द,र,मि,याँ
baa,ri,n	बा,रि,याँ
chha,la,kaa,ye	छ,ल,का,ए
du,vaa,o	दु,वा,ओ
sa,ma,jha,ni	स,म,झ,नी
sa,ma,jha,ne	स,म,झ,ने
da,r,kaa,r	द,र,का,र
fi,la,haa,la	फ़ि,ल,हा,ल
phi,la,haa,la	फि,ल,हा,ल
bhu,laa,ye,nge	भु,ला,एं,गे
ma,ha,ka,ti	म,ह,क,ती
ma,ha,ka,taa	म,ह,क,ता
ja,vaa,ni,n	ज,वा,नि,याँ
fai,sa,laa	फै,स,ला
fai,sa,laa	फ़ै,स,ला
fai,sa,le	फ़ै,स,ले
fai,sa,le	फै,स,ले
ma,ha,kaa	म,ह,का
taa,r,ne	ता,र,ने
di,vaa,n,gi	दी,वा,न,गी
sa,mbha,la,te	स,म्भ,ल,ते
ra,ga,vaa,yi	रं,ग,वा,ई
kaa,la,kaa,ji	का,ल,का,जी
bo,luu	बो,लूँ
	c,a,n,n,o,t, ,u,n,d,e,r,s,t,a,n,d
mi,laa,n,gi	मि,ला,ऊँ,गी
mi,laa,n,gaa	मि,ला,ऊँ,गा
gi,r,taa	गि,र,ता
gu,n,gu,na	गु,न,गु,ना
bi,r,ya,ni	बि,र,या,नी
ma,ta,ki,n	म,ट,कि,याँ
tu,ta,te	टू,ट,ते
chuu,di,n	चू,ड़ि,याँ
la,da,ka,pa,n	ल,ड़,क,प,न
cha,laa,n,gi	च,ला,ऊँ,गी
raa,ja,ni,ti,ka	रा,ज,नी,ति,क
ma,na,o,nge	म,ना,ओ,गे
bi,ya,n	बी,या,वाँ
khuu,ba,suu,r,ta	खू,ब,सू,र,त
ba,ta,laa,yuu	ब,त,ला,ऊं
pai,ru	पै,रूँ
ta,ka,raa	ट,क,रा
khwaa,i,sha	ख्वा,इ,श
bha,laa,yi	भ,ला,ई
saa,pa,non	सा,प,नों
da,ba,la	ड,ब,ल
ma,kaa	म,काँ
na,ga,haa	ना,ग,हाँ
ta,da,paa,ke	त,ड़,पा,के
fi,zaa,ye	फ़ि,ज़ा,एँ
kaa,r,too,son	का,र,तू,सों
ja,taa,yon	ज,टा,ओं
ta,pa,ka,taa	ट,प,क,ता
chu,n,taa	चु,न,ता
ta,pa,ka,ti	ट,प,क,ती
maa,goo	माँ,गूँ
sa,cha,mu,cha	स,च,मु,च
ma,ha,r,baa	म,ह,र,बाँ
ha,ta,taa	ह,ट,ता
r,ta,laa,ma	र,त,ला,म
jhaa,bu,aa	झा,बु,आ
sa,ba,ko	स,ब,को
sa,ba,ki	स,ब,की
sa,ba,ke	स,ब,के
sa,ga,tha,n	सं,ग,ठ,न
pa,r,chhaa,yi,yaan	प,र,छा,ई,यां
na,daa,ni,n	ना,दा,नि,याँ
baa,ka,pa,n	बा,क,प,न
ha,ma,zu,baa	ह,म,ज़ु,बाँ
khaa,n,paa,n	खा,न,पा,न
ta,ha,li,ya,ni	त,ह,लि,या,नी
a,njaa,n	अ,न्जा,न
u,se	उ,से
u,si	उ,सी
ta,da,paa,ye,gi	त,ड़,पा,ए,गी
bha,gaa,o	भ,गा,ओ
tu,jha,saa	तु,झ,सा
tu,jha,se	तु,झ,से
tu,jha,si	तु,झ,सी
jaa,goo	जा,गूँ
pa,laa,ni,ma,kka,ma	प,ला,नि,म,क्क,म
ta,r,mi,n	त,र,मि,याँ
i,tta,i,cha	इ,त्ता,इ,च
chhaa,yi	छा,ई
chaa,ya	चा,य
chaa	चाँ
khya,la	ख्या,ल
ka,haa	क,हाँ
kyaa,la	ख़्या,ल
ti,cha,r	टी,च,र
to,da,ke	तो,ड़,के
a,ga,daa,i,n	अं,ग,ड़ा,इ,याँ
ha,la,ki	ह,ल,की
chhu,pa,ka,r	छु,प,क,र
u,thu	उ,ठूँ
i,ti,haa,sa,kaa,ron	इ,ति,हा,स,का,रों
aa,yuu,gi	आ,ऊं,गी
aa,n,gi	आ,ऊँ,गी
ha,ma,raa,za	ह,म,रा,ज़
jaa,n,kaa,ri	जा,न,का,री
gu,ru,bhaa,yi	गु,रु,भा,ई
bhu,jaa,yon	भु,जा,ओं
du,pa,ha,ron	दु,प,ह,रों
di,vaa,n,gi	दी,वा,न,गी
maa,r,daa	मा,र,दा
pa,chha,taa,ye,gi	प,छ,ता,ए,गी
ja,la,vaa	ज,ल,वा
ja,la,ve	ज,ल,वे
i,kaa,i,yon	इ,का,इ,यों
ni,bhaa,ye,nge	नि,भा,यें,गे
ja,laa,ye	ज,ला,एँ
to,ha,ri	तो,ह,री
pa,ha,na,n	प,ह,ना,ऊँ
su	सु,रोंं
cha,ma,ke	च,म,कें
su,dhaa,ru	सु,धा,रूँ
maa,ga,ti	मां,ग,ती
maa,ga,ti	माँ,ग,ती
a,nau,pa,chaa,ri,ka	अ,नौ,प,चा,रि,क
ha,ma,n,vaa,za	ह,म,न,वा,ज़
r,ha,taa	र,ह,ता
la,ta,ke	ल,ट,के
a,ma,r,ji,ta	अ,म,र,जी,त
ta,la	टॉ,ल
ki,sa,me	कि,स,में
mai	मैं
me	में
ba,ha,laa,ye	ब,ह,ला,ए
ba,taa,n	ब,ता,ऊँ
ba,taa,o	ब,ता,ओ
taa,yi	टा,ई
tka	त्क
paa,te	पा,ते
i,mai,nyu,a,la	इ,मै,न्यु,अ,ल
ka,da,ke	क,ड़,के
du,shma,n	दु,श्म,न
ka,da,ki	क,ड़,की
u,pa,ru,kta	उ,प,रु,क्ता
ba,dhaa,u,gaa	ब,ढ़ा,उं,गा
raa,ja,gri,ha	रा,ज,गृ,ह
a,dhya,ya,n	अ,ध्य,य,न
fe,ha,ri,sta	फ़े,ह,रि,स्त
sha,r,maa,n,gi	श,र,मा,ऊँ,गी
du,ni,ya	दु,नि,या
di,shaa,uu	दि,शा,ऊ
mu,r,jhaa,ti	मु,र,झा,ती
ha,saa,yi	हँ,सा,ई
ha,saa,ye	हँ,सा,ए
mu,r,jhaa,te	मु,र,झा,ते
sa,taa,ye	स,ता,एँ
za,la,za,laa	ज़,ल,ज़,ला
ta,da,poo,gi	त,ड़,पूँ,गी
bha,r,ne	भ,र,ने
do,ha,raa,o	दो,ह,रा,ओ
praa,n,vaa,yu	प्रा,ण, ,वा,यु
bu,laa,te	बु,ला,ते
ga,da,ba,da	ग,ड़,ब,ड़
kaa,ma,de,va	का,म,दे,व
di,laa,o	दि,ला,ओ
di,laa,yi	दि,ला,ई
di,laa,ye	दि,ला,ए
bai,thu	बै,ठूँ
di,lme,i,n	दि,ल्मे,इ,न
u,ga,la,taa	उ,ग,ल,ता
mi,luu	मि,लूँ
di,khaa,yuu,gaa	दि,खा,ऊं,गा
di,khaa,n,gi	दि,खा,ऊँ,गी
ko,ya,laa	को,य,ला
ru,ka,taa	रु,क,ता
a,ma,ri,ki	अ,म,री,की
a,ha,ma,daa,baa,da	अ,ह,म,दा,बा,द
aa,dhi,n	आँ,धि,याँ
aa,ndhi,n	आ,न्धि,याँ
aa,ndhi,n	आँ,धी,याँ
sa,ha,na	स,ह,ना
a,ma,ri,ki	अ,म,री,की
kaa,ru	का,रूँ
a,ja,n,bi	अ,ज,न,बी
chhi,n,te	छी,न,ते
maa,goo	माँ,गूँ
la,ga,daa	ल,ग,दा
ha,mra,za	ह,म्रा,ज़
fi,zaa,yon	फ़ि,ज़ा,ओं
jaa,ye,gi	जा,ए,गी
hi,r,non	हि,र,नों
ya,ro	या,रो
kha,taa,ye	ख,ता,एं
bi,bi,si	बी,बी,सी
pu,kaa,r,te	पु,का,र,ते
chha,la,kaa,o	छ,ल,का,ओ
pu,kaa,r,ti	पु,का,र,ती
ba,sa,taa	ब,स,ता
kai,re,bi,ya,yi	कै,रे,बि,या,ई
	c,a,n,n,o,t, ,u,n,d,e,r,s,t,a,n,d
hi,cha,ki,n	हि,च,कि,याँ
ai,ta,baa,r	ऐ,त,बा,र
ha,vaa,ye	ह,वा,एँ
ma,rzi	म,र्ज़ी
ta,nhaa,i,yon	त,न्हा,इ,यों
ta,nhaa,yi,yon	त,न्हा,ई,यों
ma,za,ha,ba	म,ज़,ह,ब
pu,di,n	पु,ड़ि,याँ
ha,r,jaa,yi	ह,र,जा,ई
paa,ga,la,pa,na	पा,ग,ल,प,ना
n,zaa,re	न,ज़ा,रे
na,da,ki,sho,r	नं,द,कि,शो,र
kaa,tu	का,टूँ
pa,ha,chaa,na	प,ह,चा,ना
pa,ha,chaa,ne	प,ह,चा,ने
pa,ha,chaa,ni	प,ह,चा,नी
pa,ha,chaa,no	प,ह,चा,नो
poo,chha,taa	पू,छ,ता
maa,ga,taa	माँ,ग,ता
maa,ga,taa	मां,ग,ता
maa,ga,te	मां,ग,ते
r,chaa,n,gi	र,चा,ऊँ,गी
nge,ha,raa,yi	गे,ह,रा,ई
ga,ha,raa,yi	ग,ह,रा,ई
ga,ha,raa	ग,ह,रा
tu,ma,re	तु,म,रे
la,gaa,ye	ल,गा,यें
gaa,yuu	गा,ऊं
du,ri,n	दू,रि,याँ
be,choo	बे,चूँ
bha,da,kaa,ya	भ,ड़,का,या
di,la,vaa	दि,ल,वा,लोँ
ba,r,saa,n	ब,र,सा,ऊँ
to,da,na	तो,ड़,ना
pa,ha,chaa,na	प,ह,चा,ना
a	अँ
