lalache	lalache	ललचे	ललचे	
lokashabha	lokashabha	लोकसभा	लोकशभा	
lalacha	lalacha	ललचा	ललच	
piroya	piroya	पिरोया	पिरोया	
beqaraaron	beqaraaron	बेक़रारों	बेक़रारों	
phirake	phirake	फिरके	फिरके	
gavaa	gavaa	गवा	गवा	
godaam	godaam	गोदाम	गोदाम	
hatakar	hatakar	हटकर	हटकर	
chatokan	chatokan	चटोकन	चटकन	
chiraag	chiraag	चराग़	चिराग	
chiraag	chiraag	चिराग	चिराग	
churaake	churaake	चुराके	चुराके	
kaushal	kaushal	कौशल	काशल	
lehron	lehron	लहरो	लहरों	
lehron	lehron	लहरों	लहरों	
chakana	chakana	चकना	चकना	
pehchhan	pehchhan	पहचान	पहहन	
chamakaaye	chamakaaye	चमकाये	चमकाये	
dekhegee	dekhegee	देखेगी	देखेगी	
jhel	jhel	झेल	झेल	
jhel	jhel	जेल	झेल	
chunaariya	chunaariya	चुनरिया	चुनारिया	
rakhane	rakhane	रखने	रखने	
rakhana	rakhana	रखना	रखना	
kholne	kholne	खोलने	खोलने	
kholna	kholna	खोलना	खोलना	
naache	naache	नाचे	नाचे	
gunii	gunii	गुनी	गुनी	
naacho	naacho	नाचो	नाचो	
naachi	naachi	नाची	नाचि	
nawi	nawi	नवीं	नावि	
naachu	naachu	नाचू	नाचु	
linhi	linhi	लीन्ही	लिनी	
chini	chini	चीनी	चिनी	
bichhdegi	bichhdegi	बिछड़ेगी	बिछड़ेगी	
tanhaayiyon	tanhaayiyon	तन्हाइयों	तन्हाइयों	
mahalan	mahalan	महलन	महलन	
dikhawe	dikhawe	दिखावे	दिखावे	
khajrana	khajrana	खजराना	खाजरना	
kidi	kidi	कीदी	किदि	
baadashaahon	baadashaahon	बादशाहों	बादशाहों	
khanach	khanach	खनिज	खानाच	
virana	virana	वीराना	विरना	
virani	virani	वीरनी	वीरानी	
virani	virani	वीरानी	वीरानी	
lalachaaye	lalachaaye	ललचाए	ललचाये	
lalachaaye	lalachaaye	ललचाये	ललचाये	
lalachaaya	lalachaaya	ललचाया	ललचाया	
atkal	atkal	अटकल	अटकल	
tootegaa	tootegaa	टूटेगा	तोटेगा	
rijhaauungi	rijhaauungi	रिझाऊँगी	रिझाऊँगी	
pujaari	pujaari	पुजारी	पूजारी	
raaju	raaju	राजु	राजु	
raaju	raaju	राजू	राजु	
chaahiye	chaahiye	चाहिए	चाहिए	
chaahiye	chaahiye	चाहिये	चाहिए	
yahoo	yahoo	याहू	याहो	
layega	layega	लयेगा	लाएगा	
layega	layega	लाएगा	लाएगा	
raaje	raaje	राजे	राजे	
raaja	raaja	राजा	राज	
raaji	raaji	राजी	राजी	
mubaarakabaad	mubaarakabaad	मुबारकबाद	मुबारकबाद	
balidaan	balidaan	बलिदान	बलिदान	
wana	wana	वाना	वन	
bichhudana	bichhudana	बिछुड़ना	बिछुड़ाना	
duniye	duniye	दुनिया	दुनिए	
duniya	duniya	दुनियाँ	दुनिया	
duniya	duniya	दुनिय	दुनिया	
duniya	duniya	दुनिया	दुनिया	
duniya	duniya	दुनियां	दुनिया	
baazigar	baazigar	बाज़ीगर	बाज़ीगर	
sohai	sohai	सोहै	सोही	
chaahoon	chaahoon	चाहूँ	चाहूँ	
chaahoon	chaahoon	चाहूं	चाहूँ	
parbat	parbat	परबत	परबत	
parbat	parbat	परभात	परबत	
chulha	chulha	चुल्हा	चुल्हा	
chulha	chulha	चूल्हा	चुल्हा	
chulhe	chulhe	चुल्हे	चुले	
sunsaan	sunsaan	सुनसान	सुनसान	
jiit	jiit	जीत	जीत	
jiiw	jiiw	जीव	जीव	
kuen	kuen	कुएँ	केन	
beparwah	beparwah	बेपरवाह	बेपरवाह	
mehbuba	mehbuba	महबूबा	मेहबूब	
nikaloge	nikaloge	निकालोगे	निकलोगे	
nikaloge	nikaloge	निकलोगे	निकलोगे	
khilii	khilii	खिली	खिली	
milaaun	milaaun	मिलाऊँ	मिलाऊँ	
fir	fir	फ़िर	फ़िर	
fir	fir	फिर	फ़िर	
roshini	roshini	रोशनी	रोशिनी	
haayare	haayare	हायरे	हायरे	
netaaji	netaaji	नेताजी	नेताजी	
deewaanon	deewaanon	दीवानों	दीवानों	
jeevit	jeevit	जीवित	जीवित	
mohra	mohra	मोहरा	मोहरा	
nagriyaan	nariyaan	नगरिया	नारियान	
jhokha	jhokha	झोंका	झखा	
dasiye	dasiye	दसिये	दसीये	
dikhaaoonga	dikhaaoonga	दिखाऊँगा	दिखाऊँगा	
lagiyaa	lagiyaa	लगया	लगीया	
allaa	allaa	अल्लाह	अलला	
zaher	zaher	जहर	ज़हर	
zaher	zaher	ज़हर	ज़हर	
hataya	hataya	हटाया	हताया	
paavanataa	paavanataa	पावनता	पावनता	
paalki	paalki	पालकी	पालकी	
daanav	daanav	दानव	दानव	
daanam	daanam	दानम	दानम	
pulvari	pulvari	फुलवारी	पुलवारी	
leela	leela	लीला	लेला	
phirata	phirata	फिरता	फिरता	
phirate	phirate	फिरते	फिरते	
wetanmaan	wetanmaan	वेतनमान	वेतनमान	
khilaaun	khilaaun	खिलाऊँ	खिलाऊँ	
balaiyan	balaiyan	बलाइयाँ	बलियन	
hiya	hiya	हिया	हिया	
wafaon	wafaon	वफ़ाओं	वफ़ान	
taraataraa	taraataraa	तरातरा	तरातरा	
aawaaraa	aawaaraa	आवारा	आवारा	
hadon	hadon	हदों	हदों	
pichhrhe	pichhrhe	पिछड़े	पिछरे	
udataa	udataa	उड़ता	उड़ता	
ahmed	ahmed	अहमद	अहमद	
nadani	nadani	नादानी	नादानी	
shayad	shayad	शायद	शायद	
vimochan	vimochan	विमोचन	विमोचन	
shayar	shayar	शायर	शायर	
tadapane	tadapane	तड़पने	तड़पने	
tadapana	tadapana	तड़पना	तड़पाना	
tahsildaar	tahsildaar	तहसीलदार	तहसिलदार	
idli	idli	इडली	ईदली	
khona	khona	खोना	खोना	
khone	khone	खोने	खोने	
bhaane	bhaane	भाने	भाने	
soota	soota	सोता	सोता	
paakara	paakara	पाकर	पाकर	
vaadan	vaadan	वादन	वादान	
vaadaa	vaadaa	वादा	वादा	
kariyo	kariyo	करियो	करियों	
baraati	baraati	बराती	बराती	
simatanaa	simatanaa	सिमटना	सिमतना	
vishay	vishay	विषय	विशाय	
aayne	aayne	आईने	आयने	
barasaavat	barasaavat	बरसावत	बरसावत	
kaali	kaali	कालि	काली	
kaali	kaali	कारी	काली	
kaali	kaali	काली	काली	
kaali	kaali	ख़ाली	काली	
kiye	kiye	किये	किये	
kiye	kiye	किए	किये	
kiya	kiya	किय	किया	
kiya	kiya	किया	किया	
kaalo	kaalo	कालो	कालो	
kaala	kaala	काला	काल	
kaala	kaala	ख़ाला	काल	
thaak	thaak	ठाक	ठाक	
kaale	kaale	काले	काले	
kaale	kaale	काली	काले	
kaale	kaale	कारे	काले	
beetabi	beetabi	बेताबी	बेताबि	
chamakte	chamakte	चमकते	चमकते	
thaar	thaar	तार	तार	
chamakta	chamakta	चमकता	चमकता	
kaalu	kaalu	कालू	कालू	
chamakti	chamakti	चमकती	चमकती	
mahsoos	mahsoos	महसूस	महसोस	
mahakatii	mahakatii	महकती	महकती	
pahechaane	pahechaane	पहचाने	पहचाने	
qaayade	qaayade	क़ायदे	क़ायादे	
agani	agani	अगनी	अगनी	
chahakanaa	chahakanaa	चहकना	चाहकना	
kinase	kinase	किनसे	किनासे	
rich	rich	रीछ	रीच	
pataakhaa	pataakhaa	पटाखा	पताखा	
puche	puche	पूछे	पुचे	
puchh	puchh	पुछ	पूछ	
puchh	puchh	पूछो	पूछ	
puchh	puchh	पूछ	पूछ	
pucho	pucho	पुचो	पूछो	
pucho	pucho	पूछो	पूछो	
banaayaa	banaayaa	बनाया	बनाया	
afala	afala	अफ़ला	अफ़ला	
kharabi	kharabi	खराबी	खरबी	
amiron	amiron	अमीरों	अमीरों	
darbaaron	darbaaron	दरबारों	दरबारों	
jalawa	jalawa	जलवा	जलवा	
nigodee	nigodee	निगोड़ी	निगोदे	
dobara	dobara	दोबारा	डूबर	
muuthi	muuthi	मूठी	मुती	
sipaahi	sipaahi	सिपाही	सिपाही	
muuthe	muuthe	मूठे	मुठे	
vihaarinii	vihaarinii	विहारिणी	विधारीनी	
jagaanaa	jagaanaa	जगाना	जगाना	
najareeyaa	najareeyaa	नज़रिया	नाजरिया	
behane	behane	बहने	बहने	
khorii	khorii	खोरी	खोरी	
veer	veer	वीर	वीर	
khandan	khandan	खानदान	खनदान	
hichakole	hichakole	हिचकोले	हिचकोले	
tuutiya	tuutiya	तूतिया	तुतिया	
chetna	chetna	चेतना	चेतन	
saharaaon	saharaaon	सहराओं	सहरान	
firaaq	firaaq	फ़िराक़	फ़िराक़	
firaas	firaas	फ़िरास	फ़िरास	
chhuri	chhuri	छुरी	छुरी	
chhuri	chhuri	छूरी	छुरी	
khazana	khazana	खज़ाना	खज़ाना	
khazana	khazana	ख़ज़ाना	खज़ाना	
much	much	मुच	मुच	
much	much	मच	मुच	
bigadati	bigadati	बिगड़ती	बिगड़ती	
uthkar	uthkar	उठकर	उठकर	
chahane	chahane	चाहने	चाहने	
liptaa	liptaa	लिपटा	लिपता	
suhaagana	suhaagana	सुहागन	सुहागना	
bhadaane	bhadaane	बढाने	भादाने	
raamaa	raamaa	रामा	रामा	
kohu	kohu	कोहू	कोहु	
hone	hone	होने	होने	
honi	honi	होनी	होनी	
mukaade	mukaade	मुकादे	मुकादे	
jabse	jabse	जबसे	जबसे	
kamini	kamini	कामिनी	कमिनी	
nikhaarana	nikhaarana	निखारना	निखारना	
baavare	baavare	बावरे	बावरे	
banaanevaala	banaanevaala	बनानेवाला	बनानेवाला	
badhaatii	badhaatii	बढ़ाती	बढ़ाती	
garibakaane	garibakaane	ग़रीबख़ाने	गरीबकाने	
saaqiya	saaqiya	साक़िया	साक़ीया	
hai	hai	है	ही	
hai	hai	हैं	ही	
hai	hai	ही	ही	
hai	hai	हि	ही	
hai	hai	हा	ही	
hak	hak	हक	हक	
hal	hal	हाल	हल	
hal	hal	हल	हल	
haa	haa	हाँ	हा	
haa	haa	हां	हा	
haa	haa	हा	हा	
had	had	हद	हद	
hae	hae	है	ह	
hae	hae	हैं	ह	
madhosh	madhosh	मद्होश	मधोश	
hay	hay	हय	हाय	
hay	hay	हाय	हाय	
har	har	हार	हर	
har	har	हर	हर	
has	has	हास	हस	
hat	hat	हट	हत	
kajaraa	kajaraa	कजरा	कजरा	
dagaa	dagaa	दगा	दगा	
dayera	dayera	दायरा	दयरा	
saugaate	saugaate	सौगातें	सौगाते	
kaarawaan	kaarawaan	कारवान	कारवान	
dagar	dagar	डगर	डगर	
baaboo	baaboo	बाबू	बाबू	
sajaniyaa	sajaniyaa	सजनिया	सजनिया	
cheekiimiiki	cheekiimiiki	चीकीमीकी	चेकीमीकि	
gadh	gadh	गड़	गढ़	
gadi	gadi	गड़ी	गड़ी	
gadi	gadi	गाड़ी	गड़ी	
gadi	gadi	गडि	गड़ी	
gadi	gadi	घड़ी	गड़ी	
gada	gada	गड़ा	गदा	
gada	gada	घड़ा	गदा	
jhoolo	jhoolo	झूलो	झूलो	
khubasoorat	khubasoorat	खूबसूरत	खूबसूरत	
shaadamaani	shaadamaani	शादमानी	शादमानी	
badalawaaya	badalawaaya	बदलवाया	बदलवाया	
nigode	nigode	निगोड़े	निगोदे	
tasavir	tasavir	तसवीर	तसवीर	
banavaake	banavaake	बनवाके	बनवाके	
etbaar	etbaar	ऐतबार	बीतबार	
urake	urake	उरके	रूरके	
lagaale	lagaale	लगाले	लगाले	
tamanaa	tamanaa	तमना	तमना	
sawaaroon	sawaaroon	सवारूँ	सवारों	
parosaa	parosaa	परोसा	परोसा	
saraab	saraab	सराब	सराब	
saraah	saraah	सराह	सराह	
lagati	lagati	लगाती	लगती	
lagati	lagati	लगती	लगती	
huwon	huwon	हुवों	हुव	
lagata	lagata	लगता	लगता	
lagate	lagate	लगते	लगते	
lagate	lagate	लगाते	लगते	
waadee	waadee	वादी	वादी	
sarkaar	sarkaar	सरकार	सरकार	
bulaaen	bulaaen	बुलाएँ	बुलाऊँ	
bulaaen	bulaaen	बुलाएं	बुलाऊँ	
vuchith	vuchith	उचित	उचित	
dukhaake	dukhaake	दुखाके	दुखाके	
khamoshiyo	khamoshiyo	खामोशियों	खामोशियों	
khamoshiya	khamoshiya	खामोशिया	खामोशियाँ	
samjhaun	samjhaun	समझाऊं	समझाऊँ	
haahaakaar	haahaakaar	हाहाकार	हाआकार	
tanakar	tanakar	तनकर	तनकर	
abhyan	abhyan	अभियान	अभियन	
usise	usise	उसीसे	उससे	
minaa	minaa	मीना	मिना	
matwaali	matwaali	मतवाली	मतवाली	
sawaari	sawaari	सवारी	सवारी	
matwaale	matwaale	मतवाले	मतवाले	
furaqat	furaqat	फ़ुरक़त	फ़ुरक़त	
badalata	badalata	बदलता	बदलता	
badalate	badalate	बदलते	बदलते	
bahakaa	bahakaa	बहका	बहका	
badalati	badalati	बदलती	बदलती	
chaar	chaar	चार	चार	
role	role	रोले	रोले	
roli	roli	रोली	रोली	
haragiz	haragiz	हरगिज़	हरागीज़	
niyaat	niyaat	नियात	नियात	
zulafe	zulafe	ज़ुलफ़े	उलफ़	
lukana	lukana	लुकना	लूकना	
devon	devon	देवों	देव	
loree	loree	लोरी	लोरे	
saalaa	saalaa	साला	साला	
baisaakh	baisaakh	बैसाख	बैसाख	
raastaa	raastaa	रासता	रासता	
manaayaa	manaayaa	मनाया	मनाया	
peechhale	peechhale	पिछले	पिछले	
kaheti	kaheti	कहती	कहती	
kahete	kahete	कहते	कहते	
kaheta	kaheta	कहता	कहता	
mache	mache	मचे	मचे	
macha	macha	मचा	मच	
mehbooob	mehbooob	महबूब	मेहबूब	
machi	machi	मची	मचि	
chupachaap	chupachaap	चुपचाप	चुपचाप	
anoothe	anoothe	अनूठे	अनोठे	
sajte	sajte	सजते	सजते	
duubo	duubo	डूबो	डुबो	
duubi	duubi	डूबी	दूबि	
bajee	bajee	बजे	बजी	
bajee	bajee	बाजी	बजी	
anjaan	anjaan	अनजान	अनजान	
bagaanon	bagaanon	बगानों	बगानों	
dahaka	dahaka	दहका	दहका	
buum	buum	बूम	बूम	
dahake	dahake	दहके	दहके	
namaaziyon	namaaziyon	नमाज़ियों	नामाइयों	
subhein	subhein	सुबहें	सुभीन	
aada	aada	आदा	अदा	
buut	buut	बूट	उत	
likhna	likhna	लिखना	लिखना	
hasiinaa	hasiinaa	हसीना	हसीना	
likhne	likhne	लिखने	लिखने	
dilha	dilha	दिल्हा	दिल	
dabaake	dabaake	दबाके	दाबाके	
baraaton	baraaton	बरातों	बरातों	
hazoom	hazoom	हज़ूम	हज़ूम	
